30 100
AGCGGGAAGCCAATAAGCGGAGCCGAAGAT|TGAGTGAGAGTTTAACTGGTGGCTATGGTG
TATGATGGCGATGGTAGGTGAGTCTAATAA|ATCCGTTACTCGGACCGGCGGCAGATAAAA
TTAATAACGGATTTATCGAAAGAACGCAGG|TCCACTGCCGCCAATAAGCGGAGCCGAAGA
TTCATGACTATTCTAAACCCTCCTGTATCC|GCGGACCCAATAAGCGGAGCCGAAGATATC
ATCCGTTACACATCACGGAGCCCACGCTAC|GTAGGGCCCTAAAAATCACTCCCCCTACAT
TTCTAAACCCTCCTGTATCCCAAGGGCCCA|TAAGCGGAGCCGAAGATATCCGTTACGTAA
AACGCAGGAAGTGTCAAGAACCTGCGGGAA|GCCGAAGATATCCGTTACACATCACGGAGC
AAGATATCCGTTACCCCAGTCCAGAAGCCT|GCGGAGCCGAAGATATCCGTTACACTTCCA
GAGCCGAAGATATCCGTTACACAGATGGCC|CTTTCGTCCTGACCGTGCATAATTAGGTGA
CCGCGCAAGGTTTTCCAATAAGCGGAGCCG|CTGGGCTGACGAGTTTTTTCTTTCTAAGCG
AGATATCCGTTACCCTGGGGCCCTCAGTAT|TGTAACGTTTAATAACGGATTTATCGAAAG
TCCGTTACACATCACGGAGCCCACGCTACA|TAGGGCCCTAAAAATCACTCCCCCTACATC
AGACAATAGTCTGGTATCGAAGGGTAGTCA|GATATCCGTTACCTTATCAACCAATAAGCG
GAAGATATCCCAATAAGCGGAGCCGAAGAT|GGGAAGCCAATAAGCGGAGCCGAAGATATC
TATCCGTTACAACCACTGGGTACGCTGTAA|GTTTATCGGCCATACAGGAATCCAGATCTT
CATACAGGAATCCAGATCTTCATGACTATT|TGGACATCTGGATCGCTAGCGGACCCAATA
ACAGATGGCCAATAAGCGGAGCCGAAGATA|AATTAGGTGAGTATGATGGCGATGGTAGGT
TAAGCGGAGCCGAAGATATCCCAATAAGCG|TCTTTCTAAGCGGGAAGCCAATAAGCGGAG
CCAATAAGCGGAGCCGAAGATATCCGTTAC|TTTCCAATAAGCGGAGCCGAAGATATCCCA
CCGGCGGCAGATAAAACCTACCCCTCAATG|GAAATAGTCATGGCACTTTGCACGCCAATA
GAGTTTAACTGGTGGCTATGGTGGATCGAC|TATCCCAAGGGCCCAGGCGGCATGTGCAGT
CCACTGCCGCCAATAAGCGGAGCCGAAGAT|GCCACCCTCCAAAAATACGGCTACGAGAGA
TACTGGGCTGACGAGTTTTTTCTTTCTAAG|GGTACGCTGTAAGTGGACTCGTAACGACTG
TATCCCAAGGGCCCAGGCGGCATGTGCAGT|ATATCCGTTACGTAAACGTCGTCTTTTCGC
GATCGACAACTGAGTTGGAACGTTCTTTGT|GTGCAGTCCAATAAGCGGAGCCGAAGATAT
ATAAGCGGAGCCGAAGATATCCGTTACCGT|AGCGGAGCCGAAGATATCCGTTACAGCATA
AAGCGGAGCCGAAGATATCCGTTACCTTAT|TGATGGCGATGGTAGGTGAGTCTAATAACA
ATTTATCGAAAGAACGCAGGAAGTGTCAAG|CCAATAAGCGGAGCCGAAGATATCCGTTAC
ATTCTAAACCCTCCTGTATCCCAAGGGCCC|ATAAGCGGAGCCGAAGATATCCGTTACGTA
CCCTCCTGTATCCCAAGGGCCCAGGCGGCA|AGCCGAAGATATCCGTTACGTAAACGTCGT
CGTTACCTTATCAACCAATAAGCGGAGCCG|GTCTAATAACACAAGATGCACCCCCAATAA
CCCAATAAGCGGAGCCGAAGATATCCGTTA|ATAAGCGGAGCCGAAGATATCCGTTACCGT
AGTGGACTCGTAACGACTGAGTGAGAGTTT|TCATGACTATTCTAAACCCTCCTGTATCCC
AGCCGAAGATATCCGTTACTGGGCTGACGA|TCCGTTACAACCACTGGGTACGCTGTAAGT
CTGTTGTAACGTTTAATAACGGATTTATCG|GAGCAAAGGTTATCCACTGCCGCCAATAAG
TCCAATAAGCGGAGCCGAAGATATCCGTTA|CCAGATTCTTGTGCCTGTTGTAACGTTTAA
CTGCGGGAACAAACACGATAAAATACGCGC|TCACGGAGCCCACGCTACATCCAACGCCCG
ATCTGCATTTACCAATAAGCGGAGCCGAAG|TCTTTGTAGGCAGGCACCGACCGACGATCT
GAGCCGAAGATATCCCAATAAGCGGAGCCG|TAAGCGGGAAGCCAATAAGCGGAGCCGAAG
CTACCATTGTGTACGTCGCGTTAAACATAT|TATCCGTTACACAGATGGCCAATAAGCGGA
GAGCCGAAGATATCCGTTACCCCAATAAGC|GCGGAGCCGAAGATATCCCAATAAGCGGAG
GATTCTTGTGCCTGTTGTAACGTTTAATAA|TGCAGAGCCTTGAGCAAAGGTTATCCACTG
GTATTTTTTTAATGTGGACATCTGGATCGC|AAAGAACGCAGGAAGTGTCAAGAACCTGCG
GGCGATGGTAGGTGAGTCTAATAACACAAG|TACTCGGACCGGCGGCAGATAAAACCTACC
CTGACCGTGCATAATTAGGTGAGTATGATG|CCCCAATAAGCGGAGCCGAAGATATCCGTT
CCGAAGATATCCGTTACACTTCCAATAAGC|GGTAGTATGACCGCGCAAGGTTTTCCAATA
AGTCAGCTGTTACGGATTGCCCCAATAAGC|AAGCGGAGCCGAAGATATCCGTTACCCCAG
TACACAGATGGCCAATAAGCGGAGCCGAAG|CATAATTAGGTGAGTATGATGGCGATGGTA
TCGGCCATACAGGAATCCAGATCTTCATGA|TAATGTGGACATCTGGATCGCTAGCGGACC
CGAAGATATCCGTTACAGCATACAAGACAC|TATGGTGGATCGACAACTGAGTTGGAACGT
TCGAAGGGTAGTCAGCTGTTACGGATTGCC|TCAACCAATAAGCGGAGCCGAAGATATCCG
GTCCTGACCGTGCATAATTAGGTGAGTATG|TTACCCCAATAAGCGGAGCCGAAGATATCC
TGGGTACGCTGTAAGTGGACTCGTAACGAC|GGAATCCAGATCTTCATGACTATTCTAAAC
TAAGCGGAGCCGAAGATATCCGTTACACAG|CTAATACTTTCGTCCTGACCGTGCATAATT
GCGGACCCAATAAGCGGAGCCGAAGATATC|AACAAACACGATAAAATACGCGCCCGGCGA
ATAAGCGGAGCCGAAGATATCCGTTACTGG|CGAAGATATCCGTTACAACCACTGGGTACG
TTTACCAATAAGCGGAGCCGAAGATATCCG|AGGCAGGCACCGACCGACGATCTGGTTTAT
TATCGGCCATACAGGAATCCAGATCTTCAT|TTTAATGTGGACATCTGGATCGCTAGCGGA
GCAGTCCAATAAGCGGAGCCGAAGATATCC|TTCGCCAGATTCTTGTGCCTGTTGTAACGT
TTTCTTTCTAAGCGGGAAGCCAATAAGCGG|TCGTAACGACTGAGTGAGAGTTTAACTGGT
CAATAAGCGGAGCCGAAGATATCCGTTACC|ATGCACCCCCAATAAGCGGAGCCGAAGATA
GGTTTTCCAATAAGCGGAGCCGAAGATATC|ACGAGTTTTTTCTTTCTAAGCGGGAAGCCA
CCTGGGGCCCTCAGTATTTTTTTAATGTGG|AACGGATTTATCGAAAGAACGCAGGAAGTG
CAACCACTGGGTACGCTGTAAGTGGACTCG|CCATACAGGAATCCAGATCTTCATGACTAT
GTTACGTAAACGTCGTCTTTTCGCCAGATT|GCGAATTAGCAAGTCTGCATCTCCAATGCA
CGCCCGGTAGTATGACCGCGCAAGGTTTTC|CGAAGATATCCGTTACTGGGCTGACGAGTT
GTTGCCTACCATTGTGTACGTCGCGTTAAA|GAAGATATCCGTTACACAGATGGCCAATAA
TCCGTTACTCGGACCGGCGGCAGATAAAAC|TTACCGTTACACAGAAATAGTCATGGCACT
AAGATATCCGTTACAACCACTGGGTACGCT|TCTGGTTTATCGGCCATACAGGAATCCAGA
GGTAGTATGACCGCGCAAGGTTTTCCAATA|ATATCCGTTACTGGGCTGACGAGTTTTTTC
GGATCGCTAGCGGACCCAATAAGCGGAGCC|ACCTGCGGGAACAAACACGATAAAATACGC
TGTATCCCAAGGGCCCAGGCGGCATGTGCA|AGATATCCGTTACGTAAACGTCGTCTTTTC
CGAAGATATCCGTTACACAGATGGCCAATA|CGTCCTGACCGTGCATAATTAGGTGAGTAT
ACAAGACACATCTGCATTTACCAATAAGCG|TTGGAACGTTCTTTGTAGGCAGGCACCGAC
ACACTTCCAATAAGCGGAGCCGAAGATATC|CAAGGTTTTCCAATAAGCGGAGCCGAAGAT
GATATCCGTTACACTTCCAATAAGCGGAGC|TATGACCGCGCAAGGTTTTCCAATAAGCGG
ATTAGGTGAGTATGATGGCGATGGTAGGTG|AGCCGAAGATATCCGTTACTCGGACCGGCG
CCGTTACCGTTACACAGAAATAGTCATGGC|TTACAGCATACAAGACACATCTGCATTTAC
TCTAAGCGGGAAGCCAATAAGCGGAGCCGA|CGACTGAGTGAGAGTTTAACTGGTGGCTAT
TCTTCATGACTATTCTAAACCCTCCTGTAT|TAGCGGACCCAATAAGCGGAGCCGAAGATA
CGTTACCCCAGTCCAGAAGCCTCCTTCGTT|GAAGATATCCGTTACACTTCCAATAAGCGG
CGAAGATATCCGTTACCGTTACACAGAAAT|AGATATCCGTTACAGCATACAAGACACATC
CTTGTGCCTGTTGTAACGTTTAATAACGGA|GAGCCTTGAGCAAAGGTTATCCACTGCCGC
CGTGCACGGGCCGTTGCCTACCATTGTGTA|ATAAGCGGAGCCGAAGATATCCGTTACACA
CAGTCCAATAAGCGGAGCCGAAGATATCCG|TCGCCAGATTCTTGTGCCTGTTGTAACGTT
TATCCGTTACAGCATACAAGACACATCTGC|GGATCGACAACTGAGTTGGAACGTTCTTTG
GGCCCTCAGTATTTTTTTAATGTGGACATC|ATTTATCGAAAGAACGCAGGAAGTGTCAAG
TTACCAATAAGCGGAGCCGAAGATATCCGT|GGCAGGCACCGACCGACGATCTGGTTTATC
GGTGGATCGACAACTGAGTTGGAACGTTCT|GCATGTGCAGTCCAATAAGCGGAGCCGAAG
CCAATAAGCGGAGCCGAAGATATCCGTTAC|GAGTATGATGGCGATGGTAGGTGAGTCTAA
CGTTACACAGATGGCCAATAAGCGGAGCCG|GTGCATAATTAGGTGAGTATGATGGCGATG
CCGAAGATATCCGTTACCTTATCAACCAAT|ATGGTAGGTGAGTCTAATAACACAAGATGC
CCCAATAAGCGGAGCCGAAGATATCCGTTC|GTTACCCCAGTCCAGAAGCCTCCTTCGTTA
TTACACAGATGGCCAATAAGCGGAGCCGAA|GCATAATTAGGTGAGTATGATGGCGATGGT
GGTATCGAAGGGTAGTCAGCTGTTACGGAT|CTTATCAACCAATAAGCGGAGCCGAAGATA
GCGGCATGTGCAGTCCAATAAGCGGAGCCG|CGTCGTCTTTTCGCCAGATTCTTGTGCCTG
CCAGTCCAGAAGCCTCCTTCGTTAAATCTA|TCCGTTACACTTCCAATAAGCGGAGCCGAA
CTATTCTAAACCCTCCTGTATCCCAAGGGC|CAATAAGCGGAGCCGAAGATATCCGTTACG
GGATTTATCGAAAGAACGCAGGAAGTGTCA|CGCCAATAAGCGGAGCCGAAGATATCCGTT
CGCGCCCGGCGAAGCGAATTAGCAAGTCTG|GCCCGACAAGGGATAATGCAAGGTTCGAGT
AATCCAGATCTTCATGACTATTCTAAACCC|TGGATCGCTAGCGGACCCAATAAGCGGAGC
CGGAGCCGAAGATATCCGTTACAGCATACA|GGTGGCTATGGTGGATCGACAACTGAGTTG
CGGAGCCGAAGATATCCGTTCCAATAAGCG|GTCCAGAAGCCTCCTTCGTTAAATCTAATA
GCCGAAGATATCCGTTACCCCAATAAGCGG|GGAGCCGAAGATATCCCAATAAGCGGAGCC
ATAAGCGGAGCCGAAGATATCCGTTACCCT|ATTCTTGTGCCTGTTGTAACGTTTAATAAC
AGCCGAAGATATCCGTTCCAATAAGCGGAG|CAGAAGCCTCCTTCGTTAAATCTAATACTT
CGGGAAGCCAATAAGCGGAGCCGAAGATAT|AGTGAGAGTTTAACTGGTGGCTATGGTGGA
ATATCCCAATAAGCGGAGCCGAAGATATCC|AGCCAATAAGCGGAGCCGAAGATATCCGTT
TGGCCAATAAGCGGAGCCGAAGATATCCGT|GGTGAGTATGATGGCGATGGTAGGTGAGTC
ATGCAGAGCCTTGAGCAAAGGTTATCCACT|ATCGCAACGGGGTATCTTCCGGTGGGCCAC
CCGACGATCTGGTTTATCGGCCATACAGGA|GCCCTCAGTATTTTTTTAATGTGGACATCT
CTCCAATGCAGAGCCTTGAGCAAAGGTTAT|GACAAATCGCAACGGGGTATCTTCCGGTGG
CGAAGCGAATTAGCAAGTCTGCATCTCCAA|GGGATAATGCAAGGTTCGAGTTACGACAAA
GGGCCCTCAGTATTTTTTTAATGTGGACAT|GATTTATCGAAAGAACGCAGGAAGTGTCAA
CCAATAAGCGGAGCCGAAGATATCCGTTAC|AGGCACCGACCGACGATCTGGTTTATCGGC
CAAGGGGGTCGTGCACGGGCCGTTGCCTAC|TCCGTTCCAATAAGCGGAGCCGAAGATATC
TACAGGAATCCAGATCTTCATGACTATTCT|GACATCTGGATCGCTAGCGGACCCAATAAG
TCAGCTGTTACGGATTGCCCCAATAAGCGG|GCGGAGCCGAAGATATCCGTTACCCCAGTC
CAATAAGCGGAGCCGAAGATATCCGTTACC|AGTATGATGGCGATGGTAGGTGAGTCTAAT
CGATCTGGTTTATCGGCCATACAGGAATCC|TCAGTATTTTTTTAATGTGGACATCTGGAT
GTTCCAATAAGCGGAGCCGAAGATATCCGT|GTTAAATCTAATACTTTCGTCCTGACCGTG
ATCTGGTTTATCGGCCATACAGGAATCCAG|AGTATTTTTTTAATGTGGACATCTGGATCG
ATCTTCATGACTATTCTAAACCCTCCTGTA|CTAGCGGACCCAATAAGCGGAGCCGAAGAT
AGCCGAAGATATCCGTTACCGTTACACAGA|CGAAGATATCCGTTACAGCATACAAGACAC
GATATCCGTTACAGCATACAAGACACATCT|GTGGATCGACAACTGAGTTGGAACGTTCTT
CGGAGCCGAAGATATCCGTTACCCTGGGGC|TGTGCCTGTTGTAACGTTTAATAACGGATT
TAACGACTGAGTGAGAGTTTAACTGGTGGC|TCTAAACCCTCCTGTATCCCAAGGGCCCAG
GGAGCCGAAGATATCCGTTACAACCACTGG|CCGACGATCTGGTTTATCGGCCATACAGGA
GGATCGACAACTGAGTTGGAACGTTCTTTG|TGTGCAGTCCAATAAGCGGAGCCGAAGATA
AAGATATCCGTTACTGGGCTGACGAGTTTT|TACAACCACTGGGTACGCTGTAAGTGGACT
AGACACATCTGCATTTACCAATAAGCGGAG|GAACGTTCTTTGTAGGCAGGCACCGACCGA
CTTGAGCAAAGGTTATCCACTGCCGCCAAT|GGGTATCTTCCGGTGGGCCACCCTCCAAAA
TCAAGAACCTGCGGGAACAAACACGATAAA|GTTACACATCACGGAGCCCACGCTACATCC
GTATGACCGCGCAAGGTTTTCCAATAAGCG|CCGTTACTGGGCTGACGAGTTTTTTCTTTC
AAGATATCCGTTACAGCATACAAGACACAT|TGGTGGATCGACAACTGAGTTGGAACGTTC
TAATAACGGATTTATCGAAAGAACGCAGGA|CCACTGCCGCCAATAAGCGGAGCCGAAGAT
CGTTACACTTCCAATAAGCGGAGCCGAAGA|CGCGCAAGGTTTTCCAATAAGCGGAGCCGA
AGAACGCAGGAAGTGTCAAGAACCTGCGGG|GAGCCGAAGATATCCGTTACACATCACGGA
GATATCCGTTACCTTATCAACCAATAAGCG|AGGTGAGTCTAATAACACAAGATGCACCCC
TATCCGTTACCCCAATAAGCGGAGCCGAAG|AGATATCCCAATAAGCGGAGCCGAAGATAT
ACCACTGGGTACGCTGTAAGTGGACTCGTA|ATACAGGAATCCAGATCTTCATGACTATTC
ATCGCTAGCGGACCCAATAAGCGGAGCCGA|CTGCGGGAACAAACACGATAAAATACGCGC
CCTTATCAACCAATAAGCGGAGCCGAAGAT|ATAACACAAGATGCACCCCCAATAAGCGGA
CCGTTACACAGATGGCCAATAAGCGGAGCC|CGTGCATAATTAGGTGAGTATGATGGCGAT
AGCCGAAGATATCCGTTACGTAAACGTCGT|ACGCGCCCGGCGAAGCGAATTAGCAAGTCT
CCAATAAGCGGAGCCGAAGATATCCGTTAC|GTTTAACTGGTGGCTATGGTGGATCGACAA
TTCTTTCTAAGCGGGAAGCCAATAAGCGGA|CGTAACGACTGAGTGAGAGTTTAACTGGTG
GCATCTCCAATGCAGAGCCTTGAGCAAAGG|TTACGACAAATCGCAACGGGGTATCTTCCG
TCAACCAATAAGCGGAGCCGAAGATATCCG|ACAAGATGCACCCCCAATAAGCGGAGCCGA
TTACGTAAACGTCGTCTTTTCGCCAGATTC|CGAATTAGCAAGTCTGCATCTCCAATGCAG
CCGTTACCCTGGGGCCCTCAGTATTTTTTT|GTTTAATAACGGATTTATCGAAAGAACGCA
ATCTCCAATGCAGAGCCTTGAGCAAAGGTT|ACGACAAATCGCAACGGGGTATCTTCCGGT
GGGAACAAACACGATAAAATACGCGCCCGG|GGAGCCCACGCTACATCCAACGCCCGACAA
GGAGCCGAAGATATCCGTTACCCCAGTCCA|CCAATAAGCGGAGCCGAAGATATCCGTTAC
ATGACCGCGCAAGGTTTTCCAATAAGCGGA|GTTACTGGGCTGACGAGTTTTTTCTTTCTA
CGTCTTTTCGCCAGATTCTTGTGCCTGTTG|TCTGCATCTCCAATGCAGAGCCTTGAGCAA
GAGCAAAGGTTATCCACTGCCGCCAATAAG|TATCTTCCGGTGGGCCACCCTCCAAAAATA
ACACAGAAATAGTCATGGCACTTTGCACGC|AAGACACATCTGCATTTACCAATAAGCGGA
ACACAGATGGCCAATAAGCGGAGCCGAAGA|ATAATTAGGTGAGTATGATGGCGATGGTAG
GATATCCGTTACACAGATGGCCAATAAGCG|CTGACCGTGCATAATTAGGTGAGTATGATG
CTAATAACACAAGATGCACCCCCAATAAGC|GATAAAACCTACCCCTCAATGGAGAACTTC
GATATCCGTTACGTAAACGTCGTCTTTTCG|CGGCGAAGCGAATTAGCAAGTCTGCATCTC
TTCTAAGCGGGAAGCCAATAAGCGGAGCCG|ACGACTGAGTGAGAGTTTAACTGGTGGCTA
CGTTACAGCATACAAGACACATCTGCATTT|CGACAACTGAGTTGGAACGTTCTTTGTAGG
GAAGATATCCGTTACAACCACTGGGTACGC|ATCTGGTTTATCGGCCATACAGGAATCCAG
GCCAATAAGCGGAGCCGAAGATATCCGTTA|CCAAAAATACGGCTACGAGAGAGTAGGGCC
TCCAATAAGCGGAGCCGAAGATATCCGTTA|TTTTCCAATAAGCGGAGCCGAAGATATCCC
AGGGTAGTCAGCTGTTACGGATTGCCCCAA|CCAATAAGCGGAGCCGAAGATATCCGTTAC
AACTGAGTTGGAACGTTCTTTGTAGGCAGG|CCAATAAGCGGAGCCGAAGATATCCGTTAC
CCCAGGCGGCATGTGCAGTCCAATAAGCGG|GTAAACGTCGTCTTTTCGCCAGATTCTTGT
CTAAGCGGGAAGCCAATAAGCGGAGCCGAA|GACTGAGTGAGAGTTTAACTGGTGGCTATG
TGACCGTGCATAATTAGGTGAGTATGATGG|CCCAATAAGCGGAGCCGAAGATATCCGTTA
AGTGTCAAGAACCTGCGGGAACAAACACGA|ATCCGTTACACATCACGGAGCCCACGCTAC
CCGTTCCAATAAGCGGAGCCGAAGATATCC|TCGTTAAATCTAATACTTTCGTCCTGACCG
CTGTAAGTGGACTCGTAACGACTGAGTGAG|GATCTTCATGACTATTCTAAACCCTCCTGT
ATCCGTTACGTAAACGTCGTCTTTTCGCCA|CGAAGCGAATTAGCAAGTCTGCATCTCCAA
GTAACGACTGAGTGAGAGTTTAACTGGTGG|TTCTAAACCCTCCTGTATCCCAAGGGCCCA
TACCCCTCAATGGAGAACTTCGCCCGGTAG|TGCACGCCAATAAGCGGAGCCGAAGATATC
AGCCGAAGATATCCGTTACAGCATACAAGA|GGCTATGGTGGATCGACAACTGAGTTGGAA
CGAAGATATCCGTTCCAATAAGCGGAGCCG|AAGCCTCCTTCGTTAAATCTAATACTTTCG
ACGCTGTAAGTGGACTCGTAACGACTGAGT|CCAGATCTTCATGACTATTCTAAACCCTCC
TTACGGATTGCCCCAATAAGCGGAGCCGAA|CGAAGATATCCGTTACCCCAGTCCAGAAGC
GGCTATGGTGGATCGACAACTGAGTTGGAA|CAGGCGGCATGTGCAGTCCAATAAGCGGAG
GAGTATGATGGCGATGGTAGGTGAGTCTAA|GATATCCGTTACTCGGACCGGCGGCAGATA
GCGGAGCCGAAGATATCCGTTACAGCATAC|TGGTGGCTATGGTGGATCGACAACTGAGTT
TCTGCATCTCCAATGCAGAGCCTTGAGCAA|GAGTTACGACAAATCGCAACGGGGTATCTT
TAATGTGGACATCTGGATCGCTAGCGGACC|AGGAAGTGTCAAGAACCTGCGGGAACAAAC
CCCTATAGACAATAGTCTGGTATCGAAGGG|GCCGAAGATATCCGTTACCTTATCAACCAA
AAGGGGGTCGTGCACGGGCCGTTGCCTACC|CCGTTCCAATAAGCGGAGCCGAAGATATCC
GTTATCCACTGCCGCCAATAAGCGGAGCCG|GGTGGGCCACCCTCCAAAAATACGGCTACG
TGGTATCGAAGGGTAGTCAGCTGTTACGGA|CCTTATCAACCAATAAGCGGAGCCGAAGAT
ACGGAGCCCACGCTACATCCAACGCCCGAC|ATCACTCCCCCTACATCTTCCTCGTTCGCG
TATCCGTTCCAATAAGCGGAGCCGAAGATA|CCTTCGTTAAATCTAATACTTTCGTCCTGA
TGTGTACGTCGCGTTAAACATATCCCTATA|TACACAGATGGCCAATAAGCGGAGCCGAAG
ACTGAGTTGGAACGTTCTTTGTAGGCAGGC|CAATAAGCGGAGCCGAAGATATCCGTTACC
ATCCGTTACTGGGCTGACGAGTTTTTTCTT|CCACTGGGTACGCTGTAAGTGGACTCGTAA
CGGACCGGCGGCAGATAAAACCTACCCCTC|CACAGAAATAGTCATGGCACTTTGCACGCC
AGGAATCCAGATCTTCATGACTATTCTAAA|ATCTGGATCGCTAGCGGACCCAATAAGCGG
CCGTTACACATCACGGAGCCCACGCTACAT|AGGGCCCTAAAAATCACTCCCCCTACATCT
GAAGATATCCGTTCCAATAAGCGGAGCCGA|AGCCTCCTTCGTTAAATCTAATACTTTCGT
CCAATAAGCGGAGCCGAAGATATCCGTTAC|TAAGCGGAGCCGAAGATATCCGTTACCGTT
ACACATCTGCATTTACCAATAAGCGGAGCC|ACGTTCTTTGTAGGCAGGCACCGACCGACG
TATTTTTTTAATGTGGACATCTGGATCGCT|AAGAACGCAGGAAGTGTCAAGAACCTGCGG
GGCCATACAGGAATCCAGATCTTCATGACT|ATGTGGACATCTGGATCGCTAGCGGACCCA
TTTTCGCCAGATTCTTGTGCCTGTTGTAAC|CATCTCCAATGCAGAGCCTTGAGCAAAGGT
CCCAATAAGCGGAGCCGAAGATATCCGTTA|AATAAGCGGAGCCGAAGATATCCGTTACAG
CGTTACCCCAATAAGCGGAGCCGAAGATAT|ATCCCAATAAGCGGAGCCGAAGATATCCGT
TCGACAACTGAGTTGGAACGTTCTTTGTAG|GCAGTCCAATAAGCGGAGCCGAAGATATCC
ACCGACCGACGATCTGGTTTATCGGCCATA|CTGGGGCCCTCAGTATTTTTTTAATGTGGA
AGATATCCGTTACCCCAATAAGCGGAGCCG|CGAAGATATCCCAATAAGCGGAGCCGAAGA
ACACATCACGGAGCCCACGCTACATCCAAC|CCTAAAAATCACTCCCCCTACATCTTCCTC
AGTCTGCATCTCCAATGCAGAGCCTTGAGC|TCGAGTTACGACAAATCGCAACGGGGTATC
CCGTTACAACCACTGGGTACGCTGTAAGTG|TATCGGCCATACAGGAATCCAGATCTTCAT
GCCGAAGATATCCGTTACCGTTACACAGAA|GAAGATATCCGTTACAGCATACAAGACACA
TATCCACTGCCGCCAATAAGCGGAGCCGAA|TGGGCCACCCTCCAAAAATACGGCTACGAG
GAGCCGAAGATATCCGTTACCCTGGGGCCC|TGCCTGTTGTAACGTTTAATAACGGATTTA
TCGCCAGATTCTTGTGCCTGTTGTAACGTT|CTCCAATGCAGAGCCTTGAGCAAAGGTTAT
CCGAAGATATCCGTTACCCCAATAAGCGGA|GAGCCGAAGATATCCCAATAAGCGGAGCCG
GAAGATATCCGTTACGTAAACGTCGTCTTT|GCCCGGCGAAGCGAATTAGCAAGTCTGCAT
ATACAGGAATCCAGATCTTCATGACTATTC|GGACATCTGGATCGCTAGCGGACCCAATAA
CAATAAGCGGAGCCGAAGATATCCGTTACA|GGCACCGACCGACGATCTGGTTTATCGGCC
AAGTCTGCATCTCCAATGCAGAGCCTTGAG|TTCGAGTTACGACAAATCGCAACGGGGTAT
GACCGACGATCTGGTTTATCGGCCATACAG|GGGCCCTCAGTATTTTTTTAATGTGGACAT
GGCATGTGCAGTCCAATAAGCGGAGCCGAA|TCGTCTTTTCGCCAGATTCTTGTGCCTGTT
AGATATCCGTTACGTAAACGTCGTCTTTTC|CCGGCGAAGCGAATTAGCAAGTCTGCATCT
AATAAGCGGAGCCGAAGATATCCGTTACTG|CCGAAGATATCCGTTACAACCACTGGGTAC
CCGTTACGTAAACGTCGTCTTTTCGCCAGA|AAGCGAATTAGCAAGTCTGCATCTCCAATG
TCCAGAAGCCTCCTTCGTTAAATCTAATAC|TTACACTTCCAATAAGCGGAGCCGAAGATA
AGCGGAGCCGAAGATATCCGTTACCCCAAT|ATAAGCGGAGCCGAAGATATCCCAATAAGC
GGTAGTCAGCTGTTACGGATTGCCCCAATA|AATAAGCGGAGCCGAAGATATCCGTTACCC
TTCGTTAAATCTAATACTTTCGTCCTGACC|AAGCGGAGCCGAAGATATCCGTTACCCCAA
CCAATAAGCGGAGCCGAAGATATCCGTTAC|ATAAGCGGAGCCGAAGATATCCGTTACAGC
AAATCTAATACTTTCGTCCTGACCGTGCAT|AGCCGAAGATATCCGTTACCCCAATAAGCG
GCCGAAGATATCCGTTCCAATAAGCGGAGC|AGAAGCCTCCTTCGTTAAATCTAATACTTT
CGAAGATATCCGTTACCCCAGTCCAGAAGC|AAGCGGAGCCGAAGATATCCGTTACACTTC
GCTATGGTGGATCGACAACTGAGTTGGAAC|AGGCGGCATGTGCAGTCCAATAAGCGGAGC
CTTCCAATAAGCGGAGCCGAAGATATCCGT|GGTTTTCCAATAAGCGGAGCCGAAGATATC
GAAGATATCCGTTACCTTATCAACCAATAA|GGTAGGTGAGTCTAATAACACAAGATGCAC
GTGGCTATGGTGGATCGACAACTGAGTTGG|CCCAGGCGGCATGTGCAGTCCAATAAGCGG
AAAATACGCGCCCGGCGAAGCGAATTAGCA|TCCAACGCCCGACAAGGGATAATGCAAGGT
TAAGCGGGAAGCCAATAAGCGGAGCCGAAG|ACTGAGTGAGAGTTTAACTGGTGGCTATGG
TGGTGGATCGACAACTGAGTTGGAACGTTC|GGCATGTGCAGTCCAATAAGCGGAGCCGAA
CATCTGGATCGCTAGCGGACCCAATAAGCG|CAAGAACCTGCGGGAACAAACACGATAAAA
CGGCGGCAGATAAAACCTACCCCTCAATGG|AAATAGTCATGGCACTTTGCACGCCAATAA
TACCATTGTGTACGTCGCGTTAAACATATC|ATCCGTTACACAGATGGCCAATAAGCGGAG
ACCGTGCATAATTAGGTGAGTATGATGGCG|CAATAAGCGGAGCCGAAGATATCCGTTACT
ATGTGGACATCTGGATCGCTAGCGGACCCA|GAAGTGTCAAGAACCTGCGGGAACAAACAC
AGTATTTTTTTAATGTGGACATCTGGATCG|GAAAGAACGCAGGAAGTGTCAAGAACCTGC
ACTATTCTAAACCCTCCTGTATCCCAAGGG|CCAATAAGCGGAGCCGAAGATATCCGTTAC
GCGGAGCCGAAGATATCCGTTACCCCAATA|TAAGCGGAGCCGAAGATATCCCAATAAGCG
CCCAAGGGCCCAGGCGGCATGTGCAGTCCA|TCCGTTACGTAAACGTCGTCTTTTCGCCAG
GATATCCGTTACCCCAGTCCAGAAGCCTCC|GGAGCCGAAGATATCCGTTACACTTCCAAT
CAATAAGCGGAGCCGAAGATATCCGTTACA|AGAACTTCGCCCGGTAGTATGACCGCGCAA
AGATAAAACCTACCCCTCAATGGAGAACTT|CATGGCACTTTGCACGCCAATAAGCGGAGC
ATCCGTTACCCCAGTCCAGAAGCCTCCTTC|GCCGAAGATATCCGTTACACTTCCAATAAG
GCCTACCATTGTGTACGTCGCGTTAAACAT|GATATCCGTTACACAGATGGCCAATAAGCG
ATATCCGTTACCCCAGTCCAGAAGCCTCCT|GAGCCGAAGATATCCGTTACACTTCCAATA
CCGAAGATATCCGTTACTCGGACCGGCGGC|AGATATCCGTTACCGTTACACAGAAATAGT
CAAGAACCTGCGGGAACAAACACGATAAAA|TTACACATCACGGAGCCCACGCTACATCCA
CAATGGAGAACTTCGCCCGGTAGTATGACC|CAATAAGCGGAGCCGAAGATATCCGTTACT
AATAAGCGGAGCCGAAGATATCCGTTACCT|GTATGATGGCGATGGTAGGTGAGTCTAATA
AGCGGACCCAATAAGCGGAGCCGAAGATAT|GAACAAACACGATAAAATACGCGCCCGGCG
GCGGAGCCGAAGATATCCGTTACACATCAC|ACGGCTACGAGAGAGTAGGGCCCTAAAAAT
TTTTTTAATGTGGACATCTGGATCGCTAGC|AACGCAGGAAGTGTCAAGAACCTGCGGGAA
GAGAGTTTAACTGGTGGCTATGGTGGATCG|TGTATCCCAAGGGCCCAGGCGGCATGTGCA
CGGAGCCGAAGATATCCGTTACTCGGACCG|GCCGAAGATATCCGTTACCGTTACACAGAA
GCGTTAAACATATCCCTATAGACAATAGTC|GCCAATAAGCGGAGCCGAAGATATCCGTTA
GCGGAGCCGAAGATATCCGTTACTCGGACC|AGCCGAAGATATCCGTTACCGTTACACAGA
GAAGCCTCCTTCGTTAAATCTAATACTTTC|ACTTCCAATAAGCGGAGCCGAAGATATCCG
AAGTGTCAAGAACCTGCGGGAACAAACACG|TATCCGTTACACATCACGGAGCCCACGCTA
TTTCGTCCTGACCGTGCATAATTAGGTGAG|TCCGTTACCCCAATAAGCGGAGCCGAAGAT
GAGCCGAAGATATCCGTTCCAATAAGCGGA|CCAGAAGCCTCCTTCGTTAAATCTAATACT
ACCCAATAAGCGGAGCCGAAGATATCCGTT|AACACGATAAAATACGCGCCCGGCGAAGCG
GTACGCTGTAAGTGGACTCGTAACGACTGA|ATCCAGATCTTCATGACTATTCTAAACCCT
CTGGTTTATCGGCCATACAGGAATCCAGAT|TATTTTTTTAATGTGGACATCTGGATCGCT
ATCCGTTACCGTTACACAGAAATAGTCATG|CGTTACAGCATACAAGACACATCTGCATTT
AACTGGTGGCTATGGTGGATCGACAACTGA|AAGGGCCCAGGCGGCATGTGCAGTCCAATA
AGCGGAGCCGAAGATATCCGTTACTGGGCT|AGATATCCGTTACAACCACTGGGTACGCTG
CTGGGCTGACGAGTTTTTTCTTTCTAAGCG|TACGCTGTAAGTGGACTCGTAACGACTGAG
CCAGATCTTCATGACTATTCTAAACCCTCC|ATCGCTAGCGGACCCAATAAGCGGAGCCGA
ATTTTTTTAATGTGGACATCTGGATCGCTA|AGAACGCAGGAAGTGTCAAGAACCTGCGGG
GCGCAAGGTTTTCCAATAAGCGGAGCCGAA|GGGCTGACGAGTTTTTTCTTTCTAAGCGGG
CCAATAAGCGGAGCCGAAGATATCCGTTAC|GAGAACTTCGCCCGGTAGTATGACCGCGCA
ATAAGCGGAGCCGAAGATATCCGTTACCTT|TATGATGGCGATGGTAGGTGAGTCTAATAA
CCGACCGACGATCTGGTTTATCGGCCATAC|TGGGGCCCTCAGTATTTTTTTAATGTGGAC
GTACGTCGCGTTAAACATATCCCTATAGAC|ACAGATGGCCAATAAGCGGAGCCGAAGATA
GGATTGCCCCAATAAGCGGAGCCGAAGATA|GATATCCGTTACCCCAGTCCAGAAGCCTCC
TCGTTAAATCTAATACTTTCGTCCTGACCG|AGCGGAGCCGAAGATATCCGTTACCCCAAT
GGAGCCGAAGATATCCGTTACACATCACGG|GGCTACGAGAGAGTAGGGCCCTAAAAATCA
CGAAGATATCCGTTACACTTCCAATAAGCG|GTAGTATGACCGCGCAAGGTTTTCCAATAA
AAGATATCCGTTACTCGGACCGGCGGCAGA|TATCCGTTACCGTTACACAGAAATAGTCAT
CAGGCACCGACCGACGATCTGGTTTATCGG|TTACCCTGGGGCCCTCAGTATTTTTTTAAT
CCAATGCAGAGCCTTGAGCAAAGGTTATCC|CAAATCGCAACGGGGTATCTTCCGGTGGGC
GTCTGGTATCGAAGGGTAGTCAGCTGTTAC|TTACCTTATCAACCAATAAGCGGAGCCGAA
ACGATCTGGTTTATCGGCCATACAGGAATC|CTCAGTATTTTTTTAATGTGGACATCTGGA
ACCTGCGGGAACAAACACGATAAAATACGC|CATCACGGAGCCCACGCTACATCCAACGCC
ACGCAGGAAGTGTCAAGAACCTGCGGGAAC|CCGAAGATATCCGTTACACATCACGGAGCC
ACAGGAATCCAGATCTTCATGACTATTCTA|ACATCTGGATCGCTAGCGGACCCAATAAGC
GGCCCAGGCGGCATGTGCAGTCCAATAAGC|ACGTAAACGTCGTCTTTTCGCCAGATTCTT
CGGCGAAGCGAATTAGCAAGTCTGCATCTC|CAAGGGATAATGCAAGGTTCGAGTTACGAC
CCGTTGCCTACCATTGTGTACGTCGCGTTA|CCGAAGATATCCGTTACACAGATGGCCAAT
ATAGTCTGGTATCGAAGGGTAGTCAGCTGT|CCGTTACCTTATCAACCAATAAGCGGAGCC
AAGCGGAGCCGAAGATATCCGTTACCCCAG|ACCCCCAATAAGCGGAGCCGAAGATATCCG
TGCATAATTAGGTGAGTATGATGGCGATGG|AAGCGGAGCCGAAGATATCCGTTACTCGGA
CACAAGATGCACCCCCAATAAGCGGAGCCG|CCTACCCCTCAATGGAGAACTTCGCCCGGT
GTAGTATGACCGCGCAAGGTTTTCCAATAA|TATCCGTTACTGGGCTGACGAGTTTTTTCT
CTGTTACGGATTGCCCCAATAAGCGGAGCC|AGCCGAAGATATCCGTTACCCCAGTCCAGA
ATGGCGATGGTAGGTGAGTCTAATAACACA|GTTACTCGGACCGGCGGCAGATAAAACCTA
TGGCTATGGTGGATCGACAACTGAGTTGGA|CCAGGCGGCATGTGCAGTCCAATAAGCGGA
ATGTGCAGTCCAATAAGCGGAGCCGAAGAT|TCTTTTCGCCAGATTCTTGTGCCTGTTGTA
GAACCTGCGGGAACAAACACGATAAAATAC|CACATCACGGAGCCCACGCTACATCCAACG
GAGCCTTGAGCAAAGGTTATCCACTGCCGC|AACGGGGTATCTTCCGGTGGGCCACCCTCC
TTACAACCACTGGGTACGCTGTAAGTGGAC|CGGCCATACAGGAATCCAGATCTTCATGAC
CTCAGTATTTTTTTAATGTGGACATCTGGA|ATCGAAAGAACGCAGGAAGTGTCAAGAACC
GCACGGGCCGTTGCCTACCATTGTGTACGT|AGCGGAGCCGAAGATATCCGTTACACAGAT
GCCGAAGATATCCCAATAAGCGGAGCCGAA|AGCGGGAAGCCAATAAGCGGAGCCGAAGAT
AGCGGAGCCGAAGATATCCGTTCCAATAAG|CAGTCCAGAAGCCTCCTTCGTTAAATCTAA
TATAGACAATAGTCTGGTATCGAAGGGTAG|GAAGATATCCGTTACCTTATCAACCAATAA
ACTGGGTACGCTGTAAGTGGACTCGTAACG|CAGGAATCCAGATCTTCATGACTATTCTAA
AGTCATGGCACTTTGCACGCCAATAAGCGG|TGCATTTACCAATAAGCGGAGCCGAAGATA
CCAATAAGCGGAGCCGAAGATATCCGTTCC|TTACCCCAGTCCAGAAGCCTCCTTCGTTAA
AAGACACATCTGCATTTACCAATAAGCGGA|GGAACGTTCTTTGTAGGCAGGCACCGACCG
GACCGGCGGCAGATAAAACCTACCCCTCAA|CAGAAATAGTCATGGCACTTTGCACGCCAA
TTTTTCTTTCTAAGCGGGAAGCCAATAAGC|ACTCGTAACGACTGAGTGAGAGTTTAACTG
TGTTGTAACGTTTAATAACGGATTTATCGA|AGCAAAGGTTATCCACTGCCGCCAATAAGC
GACTGAGTGAGAGTTTAACTGGTGGCTATG|AACCCTCCTGTATCCCAAGGGCCCAGGCGG
CACATCTGCATTTACCAATAAGCGGAGCCG|CGTTCTTTGTAGGCAGGCACCGACCGACGA
TGGGGCCCTCAGTATTTTTTTAATGTGGAC|CGGATTTATCGAAAGAACGCAGGAAGTGTC
CGAATTAGCAAGTCTGCATCTCCAATGCAG|AATGCAAGGTTCGAGTTACGACAAATCGCA
CACGGAGCCCACGCTACATCCAACGCCCGA|AATCACTCCCCCTACATCTTCCTCGTTCGC
AAACACGATAAAATACGCGCCCGGCGAAGC|CACGCTACATCCAACGCCCGACAAGGGATA
ATCCCTATAGACAATAGTCTGGTATCGAAG|GAGCCGAAGATATCCGTTACCTTATCAACC
TCGCGTTAAACATATCCCTATAGACAATAG|TGGCCAATAAGCGGAGCCGAAGATATCCGT
AACCTACCCCTCAATGGAGAACTTCGCCCG|ACTTTGCACGCCAATAAGCGGAGCCGAAGA
ATAAGCGGAGCCGAAGATATCCGTTACACA|AAATACGGCTACGAGAGAGTAGGGCCCTAA
GGAACGTTCTTTGTAGGCAGGCACCGACCG|GGAGCCGAAGATATCCGTTACCCTGGGGCC
GATATCCGTTCCAATAAGCGGAGCCGAAGA|CTCCTTCGTTAAATCTAATACTTTCGTCCT
ATCCGTTACCCCAATAAGCGGAGCCGAAGA|GATATCCCAATAAGCGGAGCCGAAGATATC
AAGATATCCGTTACCCCAATAAGCGGAGCC|CCGAAGATATCCCAATAAGCGGAGCCGAAG
GTCGCGTTAAACATATCCCTATAGACAATA|ATGGCCAATAAGCGGAGCCGAAGATATCCG
TAGACAATAGTCTGGTATCGAAGGGTAGTC|AGATATCCGTTACCTTATCAACCAATAAGC
TACTCGGACCGGCGGCAGATAAAACCTACC|GTTACACAGAAATAGTCATGGCACTTTGCA
CCAATAAGCGGAGCCGAAGATATCCGTTAC|AAATCTAATACTTTCGTCCTGACCGTGCAT
TCCGTTACCCTGGGGCCCTCAGTATTTTTT|CGTTTAATAACGGATTTATCGAAAGAACGC
TTTTCTTTCTAAGCGGGAAGCCAATAAGCG|CTCGTAACGACTGAGTGAGAGTTTAACTGG
ACTGCCGCCAATAAGCGGAGCCGAAGATAT|CACCCTCCAAAAATACGGCTACGAGAGAGT
AGAGTTTAACTGGTGGCTATGGTGGATCGA|GTATCCCAAGGGCCCAGGCGGCATGTGCAG
CTGGTATCGAAGGGTAGTCAGCTGTTACGG|ACCTTATCAACCAATAAGCGGAGCCGAAGA
AAGCGGAGCCGAAGATATCCCAATAAGCGG|CTTTCTAAGCGGGAAGCCAATAAGCGGAGC
GAATCCAGATCTTCATGACTATTCTAAACC|CTGGATCGCTAGCGGACCCAATAAGCGGAG
TCCCAATAAGCGGAGCCGAAGATATCCGTT|CAATAAGCGGAGCCGAAGATATCCGTTACA
GTGAGTCTAATAACACAAGATGCACCCCCA|GCGGCAGATAAAACCTACCCCTCAATGGAG
TATCCCTATAGACAATAGTCTGGTATCGAA|GGAGCCGAAGATATCCGTTACCTTATCAAC
TTACCGTTACACAGAAATAGTCATGGCACT|CAGCATACAAGACACATCTGCATTTACCAA
ACCCCAATAAGCGGAGCCGAAGATATCCGT|CAATAAGCGGAGCCGAAGATATCCGTTACC
GAGCCGAAGATATCCGTTACACATCACGGA|GCTACGAGAGAGTAGGGCCCTAAAAATCAC
TGAGCAAAGGTTATCCACTGCCGCCAATAA|GTATCTTCCGGTGGGCCACCCTCCAAAAAT
TCCGTTACAACCACTGGGTACGCTGTAAGT|TTATCGGCCATACAGGAATCCAGATCTTCA
GTCAGCTGTTACGGATTGCCCCAATAAGCG|AGCGGAGCCGAAGATATCCGTTACCCCAGT
GTATCCCAAGGGCCCAGGCGGCATGTGCAG|GATATCCGTTACGTAAACGTCGTCTTTTCG
GAAGCCAATAAGCGGAGCCGAAGATATCCG|GAGAGTTTAACTGGTGGCTATGGTGGATCG
AGATATCCGTTCCAATAAGCGGAGCCGAAG|CCTCCTTCGTTAAATCTAATACTTTCGTCC
AGATGCACCCCCAATAAGCGGAGCCGAAGA|CCCCTCAATGGAGAACTTCGCCCGGTAGTA
GATGGCCAATAAGCGGAGCCGAAGATATCC|TAGGTGAGTATGATGGCGATGGTAGGTGAG
TGCATCTCCAATGCAGAGCCTTGAGCAAAG|GTTACGACAAATCGCAACGGGGTATCTTCC
AATAAGCGGAGCCGAAGATATCCGTTACTC|AGCGGAGCCGAAGATATCCGTTACCGTTAC
GCCATACAGGAATCCAGATCTTCATGACTA|TGTGGACATCTGGATCGCTAGCGGACCCAA
ATCTAATACTTTCGTCCTGACCGTGCATAA|CCGAAGATATCCGTTACCCCAATAAGCGGA
TATCAACCAATAAGCGGAGCCGAAGATATC|ACACAAGATGCACCCCCAATAAGCGGAGCC
TATCCGTTACACAGATGGCCAATAAGCGGA|GACCGTGCATAATTAGGTGAGTATGATGGC
GCACCCCCAATAAGCGGAGCCGAAGATATC|TCAATGGAGAACTTCGCCCGGTAGTATGAC
AATAAGCGGAGCCGAAGATATCCGTTACAA|GCACCGACCGACGATCTGGTTTATCGGCCA
AAACGTCGTCTTTTCGCCAGATTCTTGTGC|AGCAAGTCTGCATCTCCAATGCAGAGCCTT
AAGCGGAGCCGAAGATATCCGTTACACAGA|TAATACTTTCGTCCTGACCGTGCATAATTA
CCCCAGTCCAGAAGCCTCCTTCGTTAAATC|TATCCGTTACACTTCCAATAAGCGGAGCCG
AACGTTCTTTGTAGGCAGGCACCGACCGAC|AGCCGAAGATATCCGTTACCCTGGGGCCCT
CAAGGTTTTCCAATAAGCGGAGCCGAAGAT|CTGACGAGTTTTTTCTTTCTAAGCGGGAAG
AATAAGCGGAGCCGAAGATATCCGTTACGT|CGATAAAATACGCGCCCGGCGAAGCGAATT
CCAGATTCTTGTGCCTGTTGTAACGTTTAA|CAATGCAGAGCCTTGAGCAAAGGTTATCCA
TCCGTTCCAATAAGCGGAGCCGAAGATATC|TTCGTTAAATCTAATACTTTCGTCCTGACC
ACCTTATCAACCAATAAGCGGAGCCGAAGA|AATAACACAAGATGCACCCCCAATAAGCGG
TACCTTATCAACCAATAAGCGGAGCCGAAG|TAATAACACAAGATGCACCCCCAATAAGCG
CAGCATACAAGACACATCTGCATTTACCAA|ACTGAGTTGGAACGTTCTTTGTAGGCAGGC
AGTCTGGTATCGAAGGGTAGTCAGCTGTTA|GTTACCTTATCAACCAATAAGCGGAGCCGA
AGCATACAAGACACATCTGCATTTACCAAT|CTGAGTTGGAACGTTCTTTGTAGGCAGGCA
CCCCTCAATGGAGAACTTCGCCCGGTAGTA|CACGCCAATAAGCGGAGCCGAAGATATCCG
CGAAGATATCCGTTACCCCAATAAGCGGAG|AGCCGAAGATATCCCAATAAGCGGAGCCGA
AAGGGCCCAGGCGGCATGTGCAGTCCAATA|GTTACGTAAACGTCGTCTTTTCGCCAGATT
CCGCCAATAAGCGGAGCCGAAGATATCCGT|CTCCAAAAATACGGCTACGAGAGAGTAGGG
GCTGACGAGTTTTTTCTTTCTAAGCGGGAA|CTGTAAGTGGACTCGTAACGACTGAGTGAG
CCAATAAGCGGAGCCGAAGATATCCGTTAC|CAGATTCTTGTGCCTGTTGTAACGTTTAAT
GGAACAAACACGATAAAATACGCGCCCGGC|GAGCCCACGCTACATCCAACGCCCGACAAG
AAGCGGAGCCGAAGATATCCGTTACAACCA|CCGACCGACGATCTGGTTTATCGGCCATAC
CGGAGCCGAAGATATCCGTTACTGGGCTGA|ATATCCGTTACAACCACTGGGTACGCTGTA
ACACGATAAAATACGCGCCCGGCGAAGCGA|CGCTACATCCAACGCCCGACAAGGGATAAT
GATTTATCGAAAGAACGCAGGAAGTGTCAA|GCCAATAAGCGGAGCCGAAGATATCCGTTA
GACGATCTGGTTTATCGGCCATACAGGAAT|CCTCAGTATTTTTTTAATGTGGACATCTGG
CCCGGCGAAGCGAATTAGCAAGTCTGCATC|GACAAGGGATAATGCAAGGTTCGAGTTACG
CTAATACTTTCGTCCTGACCGTGCATAATT|GAAGATATCCGTTACCCCAATAAGCGGAGC
TAAGCGGAGCCGAAGATATCCGTTACTGGG|GAAGATATCCGTTACAACCACTGGGTACGC
AAGCGGAGCCGAAGATATCCGTTACTGGGC|AAGATATCCGTTACAACCACTGGGTACGCT
GAGTCTAATAACACAAGATGCACCCCCAAT|GGCAGATAAAACCTACCCCTCAATGGAGAA
GCCGAAGATATCCGTTACCTTATCAACCAA|GATGGTAGGTGAGTCTAATAACACAAGATG
CTCGTAACGACTGAGTGAGAGTTTAACTGG|CTATTCTAAACCCTCCTGTATCCCAAGGGC
AGCCGAAGATATCCGTTACCTTATCAACCA|CGATGGTAGGTGAGTCTAATAACACAAGAT
TCTAATACTTTCGTCCTGACCGTGCATAAT|CGAAGATATCCGTTACCCCAATAAGCGGAG
TGCACGGGCCGTTGCCTACCATTGTGTACG|AAGCGGAGCCGAAGATATCCGTTACACAGA
GCCTGTTGTAACGTTTAATAACGGATTTAT|TTGAGCAAAGGTTATCCACTGCCGCCAATA
TATGGTGGATCGACAACTGAGTTGGAACGT|GCGGCATGTGCAGTCCAATAAGCGGAGCCG
AATAAGCGGAGCCGAAGATATCCGTTACAG|TTAACTGGTGGCTATGGTGGATCGACAACT
GAAGATATCCGTTACTGGGCTGACGAGTTT|TTACAACCACTGGGTACGCTGTAAGTGGAC
TTTATCGGCCATACAGGAATCCAGATCTTC|TTTTTAATGTGGACATCTGGATCGCTAGCG
CAATAAGCGGAGCCGAAGATATCCGTTACA|AATCTAATACTTTCGTCCTGACCGTGCATA
AGTCCAATAAGCGGAGCCGAAGATATCCGT|CGCCAGATTCTTGTGCCTGTTGTAACGTTT
GTCTGCATCTCCAATGCAGAGCCTTGAGCA|CGAGTTACGACAAATCGCAACGGGGTATCT
CCGTTACTGGGCTGACGAGTTTTTTCTTTC|ACTGGGTACGCTGTAAGTGGACTCGTAACG
ATAAAACCTACCCCTCAATGGAGAACTTCG|TGGCACTTTGCACGCCAATAAGCGGAGCCG
GAACGCAGGAAGTGTCAAGAACCTGCGGGA|AGCCGAAGATATCCGTTACACATCACGGAG
CAATAAGCGGAGCCGAAGATATCCGTTCCA|TACCCCAGTCCAGAAGCCTCCTTCGTTAAA
AACACAAGATGCACCCCCAATAAGCGGAGC|AACCTACCCCTCAATGGAGAACTTCGCCCG
CAGATTCTTGTGCCTGTTGTAACGTTTAAT|AATGCAGAGCCTTGAGCAAAGGTTATCCAC
CCTTGAGCAAAGGTTATCCACTGCCGCCAA|GGGGTATCTTCCGGTGGGCCACCCTCCAAA
GTTTTTTCTTTCTAAGCGGGAAGCCAATAA|GGACTCGTAACGACTGAGTGAGAGTTTAAC
GCCAATAAGCGGAGCCGAAGATATCCGTTA|AGTTTAACTGGTGGCTATGGTGGATCGACA
AGATTCTTGTGCCTGTTGTAACGTTTAATA|ATGCAGAGCCTTGAGCAAAGGTTATCCACT
CTCCTTCGTTAAATCTAATACTTTCGTCCT|CAATAAGCGGAGCCGAAGATATCCGTTACC
AGTATGATGGCGATGGTAGGTGAGTCTAAT|ATATCCGTTACTCGGACCGGCGGCAGATAA
ATATCCGTTCCAATAAGCGGAGCCGAAGAT|TCCTTCGTTAAATCTAATACTTTCGTCCTG
CCGAAGATATCCGTTACAACCACTGGGTAC|CGATCTGGTTTATCGGCCATACAGGAATCC
CCAATAAGCGGAGCCGAAGATATCCGTTAC|CACGATAAAATACGCGCCCGGCGAAGCGAA
TCCAATGCAGAGCCTTGAGCAAAGGTTATC|ACAAATCGCAACGGGGTATCTTCCGGTGGG
ATATCCGTTACCCTGGGGCCCTCAGTATTT|TAACGTTTAATAACGGATTTATCGAAAGAA
CGGAGCCGAAGATATCCGTTACCTTATCAA|TGGCGATGGTAGGTGAGTCTAATAACACAA
ATCCGTTACCTTATCAACCAATAAGCGGAG|TGAGTCTAATAACACAAGATGCACCCCCAA
TAGGTGAGTATGATGGCGATGGTAGGTGAG|CCGAAGATATCCGTTACTCGGACCGGCGGC
GCATTTACCAATAAGCGGAGCCGAAGATAT|TGTAGGCAGGCACCGACCGACGATCTGGTT
ACGGATTGCCCCAATAAGCGGAGCCGAAGA|AAGATATCCGTTACCCCAGTCCAGAAGCCT
GCGGCAGATAAAACCTACCCCTCAATGGAG|ATAGTCATGGCACTTTGCACGCCAATAAGC
CAATAAGCGGAGCCGAAGATATCCGTTACC|AGATTCTTGTGCCTGTTGTAACGTTTAATA
GCCGAAGATATCCGTTACAACCACTGGGTA|ACGATCTGGTTTATCGGCCATACAGGAATC
TCATGGCACTTTGCACGCCAATAAGCGGAG|CATTTACCAATAAGCGGAGCCGAAGATATC
AAGATATCCGTTACACTTCCAATAAGCGGA|AGTATGACCGCGCAAGGTTTTCCAATAAGC
AACATATCCCTATAGACAATAGTCTGGTAT|AAGCGGAGCCGAAGATATCCGTTACCTTAT
TAAACCCTCCTGTATCCCAAGGGCCCAGGC|GCGGAGCCGAAGATATCCGTTACGTAAACG
ACTCGGACCGGCGGCAGATAAAACCTACCC|TTACACAGAAATAGTCATGGCACTTTGCAC
GTTACGGATTGCCCCAATAAGCGGAGCCGA|CCGAAGATATCCGTTACCCCAGTCCAGAAG
ATATCCGTTACCTTATCAACCAATAAGCGG|GGTGAGTCTAATAACACAAGATGCACCCCC
GAAGATATCCGTTACTCGGACCGGCGGCAG|ATATCCGTTACCGTTACACAGAAATAGTCA
ATATCCGTTACCGTTACACAGAAATAGTCA|TCCGTTACAGCATACAAGACACATCTGCAT
TCCGTTACACAGATGGCCAATAAGCGGAGC|CCGTGCATAATTAGGTGAGTATGATGGCGA
TTATCCACTGCCGCCAATAAGCGGAGCCGA|GTGGGCCACCCTCCAAAAATACGGCTACGA
TAAGCGGAGCCGAAGATATCCGTTACAACC|ACCGACCGACGATCTGGTTTATCGGCCATA
GCCTTGAGCAAAGGTTATCCACTGCCGCCA|CGGGGTATCTTCCGGTGGGCCACCCTCCAA
CACGCCAATAAGCGGAGCCGAAGATATCCG|GCGGAGCCGAAGATATCCGTTACAACCACT
ATCGAAAGAACGCAGGAAGTGTCAAGAACC|TAAGCGGAGCCGAAGATATCCGTTACACAT
ATACTTTCGTCCTGACCGTGCATAATTAGG|GATATCCGTTACCCCAATAAGCGGAGCCGA
CTTTTCGCCAGATTCTTGTGCCTGTTGTAA|GCATCTCCAATGCAGAGCCTTGAGCAAAGG
GAGCCGAAGATATCCGTTACCCCAGTCCAG|CAATAAGCGGAGCCGAAGATATCCGTTACA
GGAAGTGTCAAGAACCTGCGGGAACAAACA|GATATCCGTTACACATCACGGAGCCCACGC
TCTGCATTTACCAATAAGCGGAGCCGAAGA|CTTTGTAGGCAGGCACCGACCGACGATCTG
TGCACGCCAATAAGCGGAGCCGAAGATATC|AAGCGGAGCCGAAGATATCCGTTACAACCA
TTTCCAATAAGCGGAGCCGAAGATATCCCA|AGTTTTTTCTTTCTAAGCGGGAAGCCAATA
ATAACGGATTTATCGAAAGAACGCAGGAAG|ACTGCCGCCAATAAGCGGAGCCGAAGATAT
GCGAATTAGCAAGTCTGCATCTCCAATGCA|TAATGCAAGGTTCGAGTTACGACAAATCGC
TAAACGTCGTCTTTTCGCCAGATTCTTGTG|TAGCAAGTCTGCATCTCCAATGCAGAGCCT
CGACTGAGTGAGAGTTTAACTGGTGGCTAT|AAACCCTCCTGTATCCCAAGGGCCCAGGCG
AGCCGAAGATATCCGTTACTCGGACCGGCG|GAAGATATCCGTTACCGTTACACAGAAATA
AGATATCCGTTACTCGGACCGGCGGCAGAT|ATCCGTTACCGTTACACAGAAATAGTCATG
AAGATATCCGTTACCCTGGGGCCCTCAGTA|TTGTAACGTTTAATAACGGATTTATCGAAA
CGAAGGGTAGTCAGCTGTTACGGATTGCCC|CAACCAATAAGCGGAGCCGAAGATATCCGT
CTGGGTACGCTGTAAGTGGACTCGTAACGA|AGGAATCCAGATCTTCATGACTATTCTAAA
TTGTGTACGTCGCGTTAAACATATCCCTAT|TTACACAGATGGCCAATAAGCGGAGCCGAA
CCTACCCCTCAATGGAGAACTTCGCCCGGT|TTTGCACGCCAATAAGCGGAGCCGAAGATA
GTGGATCGACAACTGAGTTGGAACGTTCTT|CATGTGCAGTCCAATAAGCGGAGCCGAAGA
TGAGTGAGAGTTTAACTGGTGGCTATGGTG|CCTCCTGTATCCCAAGGGCCCAGGCGGCAT
TGTAACGTTTAATAACGGATTTATCGAAAG|AAAGGTTATCCACTGCCGCCAATAAGCGGA
TCATGACTATTCTAAACCCTCCTGTATCCC|CGGACCCAATAAGCGGAGCCGAAGATATCC
ACTTTCGTCCTGACCGTGCATAATTAGGTG|TATCCGTTACCCCAATAAGCGGAGCCGAAG
TGACCGCGCAAGGTTTTCCAATAAGCGGAG|TTACTGGGCTGACGAGTTTTTTCTTTCTAA
GGAATCCAGATCTTCATGACTATTCTAAAC|TCTGGATCGCTAGCGGACCCAATAAGCGGA
CCTCCTTCGTTAAATCTAATACTTTCGTCC|CCAATAAGCGGAGCCGAAGATATCCGTTAC
GAACAAACACGATAAAATACGCGCCCGGCG|AGCCCACGCTACATCCAACGCCCGACAAGG
ACGTTCTTTGTAGGCAGGCACCGACCGACG|GCCGAAGATATCCGTTACCCTGGGGCCCTC
GCAGGAAGTGTCAAGAACCTGCGGGAACAA|GAAGATATCCGTTACACATCACGGAGCCCA
CGTTCTTTGTAGGCAGGCACCGACCGACGA|CCGAAGATATCCGTTACCCTGGGGCCCTCA
GAAGGGTAGTCAGCTGTTACGGATTGCCCC|AACCAATAAGCGGAGCCGAAGATATCCGTT
AAAGGTTATCCACTGCCGCCAATAAGCGGA|TTCCGGTGGGCCACCCTCCAAAAATACGGC
TGCACCCCCAATAAGCGGAGCCGAAGATAT|CTCAATGGAGAACTTCGCCCGGTAGTATGA
CACATCACGGAGCCCACGCTACATCCAACG|CTAAAAATCACTCCCCCTACATCTTCCTCG
ACAAACACGATAAAATACGCGCCCGGCGAA|CCCACGCTACATCCAACGCCCGACAAGGGA
GTCTTTTCGCCAGATTCTTGTGCCTGTTGT|CTGCATCTCCAATGCAGAGCCTTGAGCAAA
TACAAGACACATCTGCATTTACCAATAAGC|GTTGGAACGTTCTTTGTAGGCAGGCACCGA
TTTAACTGGTGGCTATGGTGGATCGACAAC|CCCAAGGGCCCAGGCGGCATGTGCAGTCCA
GTTACACATCACGGAGCCCACGCTACATCC|GGCCCTAAAAATCACTCCCCCTACATCTTC
TTTTCCAATAAGCGGAGCCGAAGATATCCC|GAGTTTTTTCTTTCTAAGCGGGAAGCCAAT
ATATCCGTTACTGGGCTGACGAGTTTTTTC|AACCACTGGGTACGCTGTAAGTGGACTCGT
TAATAACACAAGATGCACCCCCAATAAGCG|ATAAAACCTACCCCTCAATGGAGAACTTCG
GGAGCCGAAGATATCCGTTACGTAAACGTC|ATACGCGCCCGGCGAAGCGAATTAGCAAGT
CGTTTAATAACGGATTTATCGAAAGAACGC|TTATCCACTGCCGCCAATAAGCGGAGCCGA
AATACTTTCGTCCTGACCGTGCATAATTAG|AGATATCCGTTACCCCAATAAGCGGAGCCG
CCCAATAAGCGGAGCCGAAGATATCCGTTA|ACACGATAAAATACGCGCCCGGCGAAGCGA
ATCAACCAATAAGCGGAGCCGAAGATATCC|CACAAGATGCACCCCCAATAAGCGGAGCCG
GCTGTTACGGATTGCCCCAATAAGCGGAGC|GAGCCGAAGATATCCGTTACCCCAGTCCAG
TAATACTTTCGTCCTGACCGTGCATAATTA|AAGATATCCGTTACCCCAATAAGCGGAGCC
GGAGCCGAAGATATCCGTTACCCCAATAAG|AGCGGAGCCGAAGATATCCCAATAAGCGGA
TGACGAGTTTTTTCTTTCTAAGCGGGAAGC|GTAAGTGGACTCGTAACGACTGAGTGAGAG
CAAGACACATCTGCATTTACCAATAAGCGG|TGGAACGTTCTTTGTAGGCAGGCACCGACC
AAGCGAATTAGCAAGTCTGCATCTCCAATG|GATAATGCAAGGTTCGAGTTACGACAAATC
AGAGCCTTGAGCAAAGGTTATCCACTGCCG|CAACGGGGTATCTTCCGGTGGGCCACCCTC
TAAGCGGAGCCGAAGATATCCGTTACACAT|AATACGGCTACGAGAGAGTAGGGCCCTAAA
TTACCTTATCAACCAATAAGCGGAGCCGAA|CTAATAACACAAGATGCACCCCCAATAAGC
AATACGCGCCCGGCGAAGCGAATTAGCAAG|CAACGCCCGACAAGGGATAATGCAAGGTTC
AACGGATTTATCGAAAGAACGCAGGAAGTG|TGCCGCCAATAAGCGGAGCCGAAGATATCC
CATGACTATTCTAAACCCTCCTGTATCCCA|GGACCCAATAAGCGGAGCCGAAGATATCCG
ACCATTGTGTACGTCGCGTTAAACATATCC|TCCGTTACACAGATGGCCAATAAGCGGAGC
AAGCGGAGCCGAAGATATCCGTTCCAATAA|CCAGTCCAGAAGCCTCCTTCGTTAAATCTA
TTACACATCACGGAGCCCACGCTACATCCA|GCCCTAAAAATCACTCCCCCTACATCTTCC
CATACAAGACACATCTGCATTTACCAATAA|GAGTTGGAACGTTCTTTGTAGGCAGGCACC
AAGGGTAGTCAGCTGTTACGGATTGCCCCA|ACCAATAAGCGGAGCCGAAGATATCCGTTA
ATAACACAAGATGCACCCCCAATAAGCGGA|AAAACCTACCCCTCAATGGAGAACTTCGCC
GACAATAGTCTGGTATCGAAGGGTAGTCAG|ATATCCGTTACCTTATCAACCAATAAGCGG
ATAAGCGGAGCCGAAGATATCCGTTACCCC|CCAATAAGCGGAGCCGAAGATATCCCAATA
TTCGTCCTGACCGTGCATAATTAGGTGAGT|CCGTTACCCCAATAAGCGGAGCCGAAGATA
CTCAATGGAGAACTTCGCCCGGTAGTATGA|GCCAATAAGCGGAGCCGAAGATATCCGTTA
ACGGGCCGTTGCCTACCATTGTGTACGTCG|CGGAGCCGAAGATATCCGTTACACAGATGG
TTATCGAAAGAACGCAGGAAGTGTCAAGAA|AATAAGCGGAGCCGAAGATATCCGTTACAC
GCCGAAGATATCCGTTACACAGATGGCCAA|TTCGTCCTGACCGTGCATAATTAGGTGAGT
AATAACGGATTTATCGAAAGAACGCAGGAA|CACTGCCGCCAATAAGCGGAGCCGAAGATA
CCTGACCGTGCATAATTAGGTGAGTATGAT|ACCCCAATAAGCGGAGCCGAAGATATCCGT
AATAAGCGGAGCCGAAGATATCCGTTACAC|AAAATACGGCTACGAGAGAGTAGGGCCCTA
AGAAGCCTCCTTCGTTAAATCTAATACTTT|CACTTCCAATAAGCGGAGCCGAAGATATCC
GGCGAAGCGAATTAGCAAGTCTGCATCTCC|AAGGGATAATGCAAGGTTCGAGTTACGACA
GGCGGCATGTGCAGTCCAATAAGCGGAGCC|ACGTCGTCTTTTCGCCAGATTCTTGTGCCT
CAGAAATAGTCATGGCACTTTGCACGCCAA|ACACATCTGCATTTACCAATAAGCGGAGCC
TATCCGTTACTGGGCTGACGAGTTTTTTCT|ACCACTGGGTACGCTGTAAGTGGACTCGTA
TTGTAACGTTTAATAACGGATTTATCGAAA|CAAAGGTTATCCACTGCCGCCAATAAGCGG
GCAAAGGTTATCCACTGCCGCCAATAAGCG|TCTTCCGGTGGGCCACCCTCCAAAAATACG
GAAGATATCCGTTACAGCATACAAGACACA|ATGGTGGATCGACAACTGAGTTGGAACGTT
AGGCACCGACCGACGATCTGGTTTATCGGC|TACCCTGGGGCCCTCAGTATTTTTTTAATG
GGACTCGTAACGACTGAGTGAGAGTTTAAC|TGACTATTCTAAACCCTCCTGTATCCCAAG
ACGGATTTATCGAAAGAACGCAGGAAGTGT|GCCGCCAATAAGCGGAGCCGAAGATATCCG
CAGGAAGTGTCAAGAACCTGCGGGAACAAA|AAGATATCCGTTACACATCACGGAGCCCAC
GGCACCGACCGACGATCTGGTTTATCGGCC|ACCCTGGGGCCCTCAGTATTTTTTTAATGT
CGTTCCAATAAGCGGAGCCGAAGATATCCG|CGTTAAATCTAATACTTTCGTCCTGACCGT
GAAAGAACGCAGGAAGTGTCAAGAACCTGC|GCGGAGCCGAAGATATCCGTTACACATCAC
GCAGAGCCTTGAGCAAAGGTTATCCACTGC|CGCAACGGGGTATCTTCCGGTGGGCCACCC
ATAAGCGGAGCCGAAGATATCCGTTACAGC|TAACTGGTGGCTATGGTGGATCGACAACTG
TAATTAGGTGAGTATGATGGCGATGGTAGG|GGAGCCGAAGATATCCGTTACTCGGACCGG
ACAGAAATAGTCATGGCACTTTGCACGCCA|GACACATCTGCATTTACCAATAAGCGGAGC
AGCCGAAGATATCCGTTACACTTCCAATAA|CCGGTAGTATGACCGCGCAAGGTTTTCCAA
ACGCCAATAAGCGGAGCCGAAGATATCCGT|CGGAGCCGAAGATATCCGTTACAACCACTG
GATATCCGTTACTGGGCTGACGAGTTTTTT|CAACCACTGGGTACGCTGTAAGTGGACTCG
GACAACTGAGTTGGAACGTTCTTTGTAGGC|AGTCCAATAAGCGGAGCCGAAGATATCCGT
CTATGGTGGATCGACAACTGAGTTGGAACG|GGCGGCATGTGCAGTCCAATAAGCGGAGCC
TTTGTAGGCAGGCACCGACCGACGATCTGG|GATATCCGTTACCCTGGGGCCCTCAGTATT
CGCCCGGCGAAGCGAATTAGCAAGTCTGCA|CCGACAAGGGATAATGCAAGGTTCGAGTTA
GTTACTGGGCTGACGAGTTTTTTCTTTCTA|TGGGTACGCTGTAAGTGGACTCGTAACGAC
ATAAGCGGAGCCGAAGATATCCGTTACACA|TCTAATACTTTCGTCCTGACCGTGCATAAT
AGTGAGAGTTTAACTGGTGGCTATGGTGGA|TCCTGTATCCCAAGGGCCCAGGCGGCATGT
GAAGATATCCGTTACACAGATGGCCAATAA|GTCCTGACCGTGCATAATTAGGTGAGTATG
TACCCTGGGGCCCTCAGTATTTTTTTAATG|AATAACGGATTTATCGAAAGAACGCAGGAA
CAATAGTCTGGTATCGAAGGGTAGTCAGCT|ATCCGTTACCTTATCAACCAATAAGCGGAG
CTGCATTTACCAATAAGCGGAGCCGAAGAT|TTTGTAGGCAGGCACCGACCGACGATCTGG
GACTCGTAACGACTGAGTGAGAGTTTAACT|GACTATTCTAAACCCTCCTGTATCCCAAGG
TAGTCAGCTGTTACGGATTGCCCCAATAAG|TAAGCGGAGCCGAAGATATCCGTTACCCCA
GGAGCCGAAGATATCCGTTACACTTCCAAT|GCCCGGTAGTATGACCGCGCAAGGTTTTCC
TCTAATAACACAAGATGCACCCCCAATAAG|AGATAAAACCTACCCCTCAATGGAGAACTT
AATAGTCTGGTATCGAAGGGTAGTCAGCTG|TCCGTTACCTTATCAACCAATAAGCGGAGC
GATATCCGTTACCCCAATAAGCGGAGCCGA|GAAGATATCCCAATAAGCGGAGCCGAAGAT
TGGCGATGGTAGGTGAGTCTAATAACACAA|TTACTCGGACCGGCGGCAGATAAAACCTAC
TATCCGTTACCCTGGGGCCCTCAGTATTTT|AACGTTTAATAACGGATTTATCGAAAGAAC
ACCGACGATCTGGTTTATCGGCCATACAGG|GGCCCTCAGTATTTTTTTAATGTGGACATC
TAAGCGGAGCCGAAGATATCCGTTACCTTA|ATGATGGCGATGGTAGGTGAGTCTAATAAC
AGATATCCGTTACAACCACTGGGTACGCTG|CTGGTTTATCGGCCATACAGGAATCCAGAT
CGGCAGATAAAACCTACCCCTCAATGGAGA|TAGTCATGGCACTTTGCACGCCAATAAGCG
CCTACCATTGTGTACGTCGCGTTAAACATA|ATATCCGTTACACAGATGGCCAATAAGCGG
TAGCAAGTCTGCATCTCCAATGCAGAGCCT|AAGGTTCGAGTTACGACAAATCGCAACGGG
GGAGCCGAAGATATCCCAATAAGCGGAGCC|CTAAGCGGGAAGCCAATAAGCGGAGCCGAA
GGTGAGTCTAATAACACAAGATGCACCCCC|GGCGGCAGATAAAACCTACCCCTCAATGGA
GTTTAATAACGGATTTATCGAAAGAACGCA|TATCCACTGCCGCCAATAAGCGGAGCCGAA
GCCAGATTCTTGTGCCTGTTGTAACGTTTA|CCAATGCAGAGCCTTGAGCAAAGGTTATCC
AAGATATCCGTTCCAATAAGCGGAGCCGAA|GCCTCCTTCGTTAAATCTAATACTTTCGTC
AAGATGCACCCCCAATAAGCGGAGCCGAAG|ACCCCTCAATGGAGAACTTCGCCCGGTAGT
ATCCAGATCTTCATGACTATTCTAAACCCT|GGATCGCTAGCGGACCCAATAAGCGGAGCC
CCTGTATCCCAAGGGCCCAGGCGGCATGTG|GAAGATATCCGTTACGTAAACGTCGTCTTT
AAAGAACGCAGGAAGTGTCAAGAACCTGCG|CGGAGCCGAAGATATCCGTTACACATCACG
TTTAATAACGGATTTATCGAAAGAACGCAG|ATCCACTGCCGCCAATAAGCGGAGCCGAAG
GAAGTGTCAAGAACCTGCGGGAACAAACAC|ATATCCGTTACACATCACGGAGCCCACGCT
ACGATAAAATACGCGCCCGGCGAAGCGAAT|CTACATCCAACGCCCGACAAGGGATAATGC
GAGTTTTTTCTTTCTAAGCGGGAAGCCAAT|GTGGACTCGTAACGACTGAGTGAGAGTTTA
TGATGGCGATGGTAGGTGAGTCTAATAACA|CCGTTACTCGGACCGGCGGCAGATAAAACC
ATAAGCGGAGCCGAAGATATCCGTTACACT|AACTTCGCCCGGTAGTATGACCGCGCAAGG
CGGCATGTGCAGTCCAATAAGCGGAGCCGA|GTCGTCTTTTCGCCAGATTCTTGTGCCTGT
CATGGCACTTTGCACGCCAATAAGCGGAGC|ATTTACCAATAAGCGGAGCCGAAGATATCC
AGAACCTGCGGGAACAAACACGATAAAATA|ACACATCACGGAGCCCACGCTACATCCAAC
CCCCAATAAGCGGAGCCGAAGATATCCGTT|TGGAGAACTTCGCCCGGTAGTATGACCGCG
CAATAAGCGGAGCCGAAGATATCCGTTACT|GCCGAAGATATCCGTTACAACCACTGGGTA
AGCGGAGCCGAAGATATCCGTTACGTAAAC|AAAATACGCGCCCGGCGAAGCGAATTAGCA
TGGAGAACTTCGCCCGGTAGTATGACCGCG|TAAGCGGAGCCGAAGATATCCGTTACTGGG
CCGAAGATATCCGTTACAGCATACAAGACA|CTATGGTGGATCGACAACTGAGTTGGAACG
TCTGGTATCGAAGGGTAGTCAGCTGTTACG|TACCTTATCAACCAATAAGCGGAGCCGAAG
GAGCCGAAGATATCCGTTACAACCACTGGG|CGACGATCTGGTTTATCGGCCATACAGGAA
TATCCGTTACCTTATCAACCAATAAGCGGA|GTGAGTCTAATAACACAAGATGCACCCCCA
AAGATATCCGTTACCGTTACACAGAAATAG|ATATCCGTTACAGCATACAAGACACATCTG
CGGATTGCCCCAATAAGCGGAGCCGAAGAT|AGATATCCGTTACCCCAGTCCAGAAGCCTC
TTACCCTGGGGCCCTCAGTATTTTTTTAAT|TAATAACGGATTTATCGAAAGAACGCAGGA
TTGAGCAAAGGTTATCCACTGCCGCCAATA|GGTATCTTCCGGTGGGCCACCCTCCAAAAA
CACCCCCAATAAGCGGAGCCGAAGATATCC|CAATGGAGAACTTCGCCCGGTAGTATGACC
CTGGTGGCTATGGTGGATCGACAACTGAGT|GGGCCCAGGCGGCATGTGCAGTCCAATAAG
GGCAGATAAAACCTACCCCTCAATGGAGAA|AGTCATGGCACTTTGCACGCCAATAAGCGG
GCACGCCAATAAGCGGAGCCGAAGATATCC|AGCGGAGCCGAAGATATCCGTTACAACCAC
ATCGAAGGGTAGTCAGCTGTTACGGATTGC|ATCAACCAATAAGCGGAGCCGAAGATATCC
CCAATAAGCGGAGCCGAAGATATCCGTTAC|CAAAAATACGGCTACGAGAGAGTAGGGCCC
GCCAATAAGCGGAGCCGAAGATATCCGTTA|TGAGTATGATGGCGATGGTAGGTGAGTCTA
AGCGGAGCCGAAGATATCCGTTACAACCAC|CGACCGACGATCTGGTTTATCGGCCATACA
AAGCGGAGCCGAAGATATCCGTTACTCGGA|GGAGCCGAAGATATCCGTTACCGTTACACA
GCGCCCGGCGAAGCGAATTAGCAAGTCTGC|CCCGACAAGGGATAATGCAAGGTTCGAGTT
AGATATCCGTTACCTTATCAACCAATAAGC|TAGGTGAGTCTAATAACACAAGATGCACCC
CACTGGGTACGCTGTAAGTGGACTCGTAAC|ACAGGAATCCAGATCTTCATGACTATTCTA
AATAAGCGGAGCCGAAGATATCCGTTACCG|AAGCGGAGCCGAAGATATCCGTTACAGCAT
TCCACTGCCGCCAATAAGCGGAGCCGAAGA|GGCCACCCTCCAAAAATACGGCTACGAGAG
CCCCAATAAGCGGAGCCGAAGATATCCGTT|CGTTACCCCAGTCCAGAAGCCTCCTTCGTT
CACGATAAAATACGCGCCCGGCGAAGCGAA|GCTACATCCAACGCCCGACAAGGGATAATG
GGAGCCGAAGATATCCGTTCCAATAAGCGG|TCCAGAAGCCTCCTTCGTTAAATCTAATAC
CCCTCAGTATTTTTTTAATGTGGACATCTG|TTATCGAAAGAACGCAGGAAGTGTCAAGAA
CTGGATCGCTAGCGGACCCAATAAGCGGAG|GAACCTGCGGGAACAAACACGATAAAATAC
GCCCGGTAGTATGACCGCGCAAGGTTTTCC|GAAGATATCCGTTACTGGGCTGACGAGTTT
GTGTACGTCGCGTTAAACATATCCCTATAG|ACACAGATGGCCAATAAGCGGAGCCGAAGA
CCGGCGAAGCGAATTAGCAAGTCTGCATCT|ACAAGGGATAATGCAAGGTTCGAGTTACGA
TTCTTTGTAGGCAGGCACCGACCGACGATC|GAAGATATCCGTTACCCTGGGGCCCTCAGT
TAAGCGGAGCCGAAGATATCCGTTACCCCA|CAATAAGCGGAGCCGAAGATATCCCAATAA
TCGTGCACGGGCCGTTGCCTACCATTGTGT|AATAAGCGGAGCCGAAGATATCCGTTACAC
TATCGAAAGAACGCAGGAAGTGTCAAGAAC|ATAAGCGGAGCCGAAGATATCCGTTACACA
CGGAGCCGAAGATATCCGTTACCGTTACAC|AGCCGAAGATATCCGTTACAGCATACAAGA
CCGAAGATATCCGTTACCCTGGGGCCCTCA|CTGTTGTAACGTTTAATAACGGATTTATCG
ATAGTCATGGCACTTTGCACGCCAATAAGC|TCTGCATTTACCAATAAGCGGAGCCGAAGA
TCCTTCGTTAAATCTAATACTTTCGTCCTG|AATAAGCGGAGCCGAAGATATCCGTTACCC
GTATGATGGCGATGGTAGGTGAGTCTAATA|TATCCGTTACTCGGACCGGCGGCAGATAAA
TGCATTTACCAATAAGCGGAGCCGAAGATA|TTGTAGGCAGGCACCGACCGACGATCTGGT
ATATCCGTTACCCCAATAAGCGGAGCCGAA|AAGATATCCCAATAAGCGGAGCCGAAGATA
CCTCAGTATTTTTTTAATGTGGACATCTGG|TATCGAAAGAACGCAGGAAGTGTCAAGAAC
TACGCTGTAAGTGGACTCGTAACGACTGAG|TCCAGATCTTCATGACTATTCTAAACCCTC
GCTAGCGGACCCAATAAGCGGAGCCGAAGA|CGGGAACAAACACGATAAAATACGCGCCCG
TGTGCCTGTTGTAACGTTTAATAACGGATT|GCCTTGAGCAAAGGTTATCCACTGCCGCCA
CGAAAGAACGCAGGAAGTGTCAAGAACCTG|AGCGGAGCCGAAGATATCCGTTACACATCA
GGGTAGTCAGCTGTTACGGATTGCCCCAAT|CAATAAGCGGAGCCGAAGATATCCGTTACC
TCCCAAGGGCCCAGGCGGCATGTGCAGTCC|ATCCGTTACGTAAACGTCGTCTTTTCGCCA
GTTCTTTGTAGGCAGGCACCGACCGACGAT|CGAAGATATCCGTTACCCTGGGGCCCTCAG
GGAGCCGAAGATATCCGTTACTGGGCTGAC|TATCCGTTACAACCACTGGGTACGCTGTAA
CCTGCGGGAACAAACACGATAAAATACGCG|ATCACGGAGCCCACGCTACATCCAACGCCC
TTATCGGCCATACAGGAATCCAGATCTTCA|TTTTAATGTGGACATCTGGATCGCTAGCGG
GGTAGGTGAGTCTAATAACACAAGATGCAC|GACCGGCGGCAGATAAAACCTACCCCTCAA
GTAAGTGGACTCGTAACGACTGAGTGAGAG|TCTTCATGACTATTCTAAACCCTCCTGTAT
ACAACCACTGGGTACGCTGTAAGTGGACTC|GCCATACAGGAATCCAGATCTTCATGACTA
AAGATATCCGTTACACAGATGGCCAATAAG|TCCTGACCGTGCATAATTAGGTGAGTATGA
ACCAATAAGCGGAGCCGAAGATATCCGTTA|CAGGCACCGACCGACGATCTGGTTTATCGG
GATGGTAGGTGAGTCTAATAACACAAGATG|TCGGACCGGCGGCAGATAAAACCTACCCCT
CGTTGCCTACCATTGTGTACGTCGCGTTAA|CGAAGATATCCGTTACACAGATGGCCAATA
GCGGAGCCGAAGATATCCGTTACCCTGGGG|TTGTGCCTGTTGTAACGTTTAATAACGGAT
AGATATCCGTTACAGCATACAAGACACATC|GGTGGATCGACAACTGAGTTGGAACGTTCT
TAACGGATTTATCGAAAGAACGCAGGAAGT|CTGCCGCCAATAAGCGGAGCCGAAGATATC
GTCCAATAAGCGGAGCCGAAGATATCCGTT|GCCAGATTCTTGTGCCTGTTGTAACGTTTA
TAACACAAGATGCACCCCCAATAAGCGGAG|AAACCTACCCCTCAATGGAGAACTTCGCCC
AATAGTCATGGCACTTTGCACGCCAATAAG|ATCTGCATTTACCAATAAGCGGAGCCGAAG
GCCGAAGATATCCGTTACTGGGCTGACGAG|CCGTTACAACCACTGGGTACGCTGTAAGTG
CGAAGATATCCGTTACCCTGGGGCCCTCAG|TGTTGTAACGTTTAATAACGGATTTATCGA
ACCAAGGGGGTCGTGCACGGGCCGTTGCCT|TATCCGTTCCAATAAGCGGAGCCGAAGATA
TCCAATAAGCGGAGCCGAAGATATCCCAAT|TTTTTTCTTTCTAAGCGGGAAGCCAATAAG
CGTTACAACCACTGGGTACGCTGTAAGTGG|ATCGGCCATACAGGAATCCAGATCTTCATG
GAAGATATCCGTTACCGTTACACAGAAATA|GATATCCGTTACAGCATACAAGACACATCT
ACGCGCCCGGCGAAGCGAATTAGCAAGTCT|CGCCCGACAAGGGATAATGCAAGGTTCGAG
AAGAACGCAGGAAGTGTCAAGAACCTGCGG|GGAGCCGAAGATATCCGTTACACATCACGG
CCGAAGATATCCGTTACTGGGCTGACGAGT|CGTTACAACCACTGGGTACGCTGTAAGTGG
GGAGCCGAAGATATCCGTTACCGTTACACA|GCCGAAGATATCCGTTACAGCATACAAGAC
AATCTAATACTTTCGTCCTGACCGTGCATA|GCCGAAGATATCCGTTACCCCAATAAGCGG
CATCTGCATTTACCAATAAGCGGAGCCGAA|TTCTTTGTAGGCAGGCACCGACCGACGATC
GTTAAATCTAATACTTTCGTCCTGACCGTG|CGGAGCCGAAGATATCCGTTACCCCAATAA
TGGAACGTTCTTTGTAGGCAGGCACCGACC|CGGAGCCGAAGATATCCGTTACCCTGGGGC
ACCGGCGGCAGATAAAACCTACCCCTCAAT|AGAAATAGTCATGGCACTTTGCACGCCAAT
GAAGATATCCGTTACCCTGGGGCCCTCAGT|GTTGTAACGTTTAATAACGGATTTATCGAA
AGCGGAGCCGAAGATATCCGTTACACTTCC|TTCGCCCGGTAGTATGACCGCGCAAGGTTT
AAGGTTTTCCAATAAGCGGAGCCGAAGATA|TGACGAGTTTTTTCTTTCTAAGCGGGAAGC
GTTACCCTGGGGCCCTCAGTATTTTTTTAA|TTAATAACGGATTTATCGAAAGAACGCAGG
AGCGGAGCCGAAGATATCCGTTACACATCA|TACGGCTACGAGAGAGTAGGGCCCTAAAAA
CGGAGCCGAAGATATCCGTTACCCCAATAA|AAGCGGAGCCGAAGATATCCCAATAAGCGG
GGTTATCCACTGCCGCCAATAAGCGGAGCC|CGGTGGGCCACCCTCCAAAAATACGGCTAC
TACCGTTACACAGAAATAGTCATGGCACTT|AGCATACAAGACACATCTGCATTTACCAAT
TACACAGAAATAGTCATGGCACTTTGCACG|CAAGACACATCTGCATTTACCAATAAGCGG
TGTCAAGAACCTGCGGGAACAAACACGATA|CCGTTACACATCACGGAGCCCACGCTACAT
CGGCCATACAGGAATCCAGATCTTCATGAC|AATGTGGACATCTGGATCGCTAGCGGACCC
AGCTGTTACGGATTGCCCCAATAAGCGGAG|GGAGCCGAAGATATCCGTTACCCCAGTCCA
CAGATGGCCAATAAGCGGAGCCGAAGATAT|ATTAGGTGAGTATGATGGCGATGGTAGGTG
AAGATATCCGTTACCTTATCAACCAATAAG|GTAGGTGAGTCTAATAACACAAGATGCACC
GGAGCCGAAGATATCCGTTACTCGGACCGG|CCGAAGATATCCGTTACCGTTACACAGAAA
CGGAGCCGAAGATATCCGTTACAACCACTG|ACCGACGATCTGGTTTATCGGCCATACAGG
GTAACGTTTAATAACGGATTTATCGAAAGA|AAGGTTATCCACTGCCGCCAATAAGCGGAG
TTTTTTCTTTCTAAGCGGGAAGCCAATAAG|GACTCGTAACGACTGAGTGAGAGTTTAACT
CAGAGCCTTGAGCAAAGGTTATCCACTGCC|GCAACGGGGTATCTTCCGGTGGGCCACCCT
ATTCTTGTGCCTGTTGTAACGTTTAATAAC|GCAGAGCCTTGAGCAAAGGTTATCCACTGC
GCCCAGGCGGCATGTGCAGTCCAATAAGCG|CGTAAACGTCGTCTTTTCGCCAGATTCTTG
GTTACCCCAATAAGCGGAGCCGAAGATATC|TCCCAATAAGCGGAGCCGAAGATATCCGTT
CAATGCAGAGCCTTGAGCAAAGGTTATCCA|AAATCGCAACGGGGTATCTTCCGGTGGGCC
GTATCGAAGGGTAGTCAGCTGTTACGGATT|TTATCAACCAATAAGCGGAGCCGAAGATAT
TGAGTATGATGGCGATGGTAGGTGAGTCTA|AGATATCCGTTACTCGGACCGGCGGCAGAT
TAAAATACGCGCCCGGCGAAGCGAATTAGC|ATCCAACGCCCGACAAGGGATAATGCAAGG
GAGCCGAAGATATCCGTTACCGTTACACAG|CCGAAGATATCCGTTACAGCATACAAGACA
TGTAAGTGGACTCGTAACGACTGAGTGAGA|ATCTTCATGACTATTCTAAACCCTCCTGTA
CGTAAACGTCGTCTTTTCGCCAGATTCTTG|ATTAGCAAGTCTGCATCTCCAATGCAGAGC
AGTCCAGAAGCCTCCTTCGTTAAATCTAAT|CGTTACACTTCCAATAAGCGGAGCCGAAGA
TACGTAAACGTCGTCTTTTCGCCAGATTCT|GAATTAGCAAGTCTGCATCTCCAATGCAGA
AATGTGGACATCTGGATCGCTAGCGGACCC|GGAAGTGTCAAGAACCTGCGGGAACAAACA
TTAGCAAGTCTGCATCTCCAATGCAGAGCC|CAAGGTTCGAGTTACGACAAATCGCAACGG
ATTGCCCCAATAAGCGGAGCCGAAGATATC|TATCCGTTACCCCAGTCCAGAAGCCTCCTT
ACAAGATGCACCCCCAATAAGCGGAGCCGA|CTACCCCTCAATGGAGAACTTCGCCCGGTA
TCCTGTATCCCAAGGGCCCAGGCGGCATGT|CGAAGATATCCGTTACGTAAACGTCGTCTT
ATATCCGTTACAGCATACAAGACACATCTG|TGGATCGACAACTGAGTTGGAACGTTCTTT
TCACGGAGCCCACGCTACATCCAACGCCCG|AAATCACTCCCCCTACATCTTCCTCGTTCG
CGTTACCGTTACACAGAAATAGTCATGGCA|TACAGCATACAAGACACATCTGCATTTACC
CACTTCCAATAAGCGGAGCCGAAGATATCC|AAGGTTTTCCAATAAGCGGAGCCGAAGATA
TTTAATGTGGACATCTGGATCGCTAGCGGA|GCAGGAAGTGTCAAGAACCTGCGGGAACAA
CGACAACTGAGTTGGAACGTTCTTTGTAGG|CAGTCCAATAAGCGGAGCCGAAGATATCCG
TCAATGGAGAACTTCGCCCGGTAGTATGAC|CCAATAAGCGGAGCCGAAGATATCCGTTAC
GAGAACTTCGCCCGGTAGTATGACCGCGCA|AGCGGAGCCGAAGATATCCGTTACTGGGCT
TCTTTTCGCCAGATTCTTGTGCCTGTTGTA|TGCATCTCCAATGCAGAGCCTTGAGCAAAG
ACTGGTGGCTATGGTGGATCGACAACTGAG|AGGGCCCAGGCGGCATGTGCAGTCCAATAA
CGGAGCCGAAGATATCCGTTACGTAAACGT|AATACGCGCCCGGCGAAGCGAATTAGCAAG
TTTCTAAGCGGGAAGCCAATAAGCGGAGCC|AACGACTGAGTGAGAGTTTAACTGGTGGCT
CAATAAGCGGAGCCGAAGATATCCGTTACA|TTTAACTGGTGGCTATGGTGGATCGACAAC
GATCGCTAGCGGACCCAATAAGCGGAGCCG|CCTGCGGGAACAAACACGATAAAATACGCG
GGACATCTGGATCGCTAGCGGACCCAATAA|TGTCAAGAACCTGCGGGAACAAACACGATA
ACCGTTACACAGAAATAGTCATGGCACTTT|GCATACAAGACACATCTGCATTTACCAATA
ATTAGCAAGTCTGCATCTCCAATGCAGAGC|GCAAGGTTCGAGTTACGACAAATCGCAACG
TCTGGATCGCTAGCGGACCCAATAAGCGGA|AGAACCTGCGGGAACAAACACGATAAAATA
AATTAGCAAGTCTGCATCTCCAATGCAGAG|TGCAAGGTTCGAGTTACGACAAATCGCAAC
CTCGGACCGGCGGCAGATAAAACCTACCCC|TACACAGAAATAGTCATGGCACTTTGCACG
TATCCGTTACCGTTACACAGAAATAGTCAT|CCGTTACAGCATACAAGACACATCTGCATT
TCGAAAGAACGCAGGAAGTGTCAAGAACCT|AAGCGGAGCCGAAGATATCCGTTACACATC
GACCGCGCAAGGTTTTCCAATAAGCGGAGC|TACTGGGCTGACGAGTTTTTTCTTTCTAAG
CTGACGAGTTTTTTCTTTCTAAGCGGGAAG|TGTAAGTGGACTCGTAACGACTGAGTGAGA
TAGTCTGGTATCGAAGGGTAGTCAGCTGTT|CGTTACCTTATCAACCAATAAGCGGAGCCG
CCACTGGGTACGCTGTAAGTGGACTCGTAA|TACAGGAATCCAGATCTTCATGACTATTCT
CACCAAGGGGGTCGTGCACGGGCCGTTGCC|ATATCCGTTCCAATAAGCGGAGCCGAAGAT
ATATCCGTTACTCGGACCGGCGGCAGATAA|CCGTTACCGTTACACAGAAATAGTCATGGC
AACGTTTAATAACGGATTTATCGAAAGAAC|GGTTATCCACTGCCGCCAATAAGCGGAGCC
CCGGTAGTATGACCGCGCAAGGTTTTCCAA|AGATATCCGTTACTGGGCTGACGAGTTTTT
TCCGTTACAGCATACAAGACACATCTGCAT|ATCGACAACTGAGTTGGAACGTTCTTTGTA
GATTGCCCCAATAAGCGGAGCCGAAGATAT|ATATCCGTTACCCCAGTCCAGAAGCCTCCT
GTGGACTCGTAACGACTGAGTGAGAGTTTA|CATGACTATTCTAAACCCTCCTGTATCCCA
ATTGTGTACGTCGCGTTAAACATATCCCTA|GTTACACAGATGGCCAATAAGCGGAGCCGA
GGCTGACGAGTTTTTTCTTTCTAAGCGGGA|GCTGTAAGTGGACTCGTAACGACTGAGTGA
GTTTTCCAATAAGCGGAGCCGAAGATATCC|CGAGTTTTTTCTTTCTAAGCGGGAAGCCAA
GCGATGGTAGGTGAGTCTAATAACACAAGA|ACTCGGACCGGCGGCAGATAAAACCTACCC
GGCACTTTGCACGCCAATAAGCGGAGCCGA|TACCAATAAGCGGAGCCGAAGATATCCGTT
TTACTCGGACCGGCGGCAGATAAAACCTAC|CGTTACACAGAAATAGTCATGGCACTTTGC
TTCTTGTGCCTGTTGTAACGTTTAATAACG|CAGAGCCTTGAGCAAAGGTTATCCACTGCC
TATTCTAAACCCTCCTGTATCCCAAGGGCC|AATAAGCGGAGCCGAAGATATCCGTTACGT
CTTCATGACTATTCTAAACCCTCCTGTATC|AGCGGACCCAATAAGCGGAGCCGAAGATAT
CAATAAGCGGAGCCGAAGATATCCGTTACC|TTCCAATAAGCGGAGCCGAAGATATCCCAA
TAAGCGGAGCCGAAGATATCCGTTACCCTG|TTCTTGTGCCTGTTGTAACGTTTAATAACG
TTACCCCAGTCCAGAAGCCTCCTTCGTTAA|AGATATCCGTTACACTTCCAATAAGCGGAG
CGTGCATAATTAGGTGAGTATGATGGCGAT|ATAAGCGGAGCCGAAGATATCCGTTACTCG
GAGTGAGAGTTTAACTGGTGGCTATGGTGG|CTCCTGTATCCCAAGGGCCCAGGCGGCATG
GGGCCGTTGCCTACCATTGTGTACGTCGCG|GAGCCGAAGATATCCGTTACACAGATGGCC
TCGTCTTTTCGCCAGATTCTTGTGCCTGTT|GTCTGCATCTCCAATGCAGAGCCTTGAGCA
TGCAGAGCCTTGAGCAAAGGTTATCCACTG|TCGCAACGGGGTATCTTCCGGTGGGCCACC
ATCCGTTACACTTCCAATAAGCGGAGCCGA|GACCGCGCAAGGTTTTCCAATAAGCGGAGC
CCTATAGACAATAGTCTGGTATCGAAGGGT|CCGAAGATATCCGTTACCTTATCAACCAAT
TAAGCGGAGCCGAAGATATCCGTTACAGCA|AACTGGTGGCTATGGTGGATCGACAACTGA
ACGTCGCGTTAAACATATCCCTATAGACAA|AGATGGCCAATAAGCGGAGCCGAAGATATC
ATGATGGCGATGGTAGGTGAGTCTAATAAC|TCCGTTACTCGGACCGGCGGCAGATAAAAC
GGAGCCGAAGATATCCGTTACCCTGGGGCC|GTGCCTGTTGTAACGTTTAATAACGGATTT
TGTGGACATCTGGATCGCTAGCGGACCCAA|AAGTGTCAAGAACCTGCGGGAACAAACACG
TAAGTGGACTCGTAACGACTGAGTGAGAGT|CTTCATGACTATTCTAAACCCTCCTGTATC
ACCAATAAGCGGAGCCGAAGATATCCGTTA|AGATGCACCCCCAATAAGCGGAGCCGAAGA
ATAAGCGGAGCCGAAGATATCCGTTACCCC|GCACCCCCAATAAGCGGAGCCGAAGATATC
CTATAGACAATAGTCTGGTATCGAAGGGTA|CGAAGATATCCGTTACCTTATCAACCAATA
TCCTGACCGTGCATAATTAGGTGAGTATGA|TACCCCAATAAGCGGAGCCGAAGATATCCG
AGATGGCCAATAAGCGGAGCCGAAGATATC|TTAGGTGAGTATGATGGCGATGGTAGGTGA
GGGGCCCTCAGTATTTTTTTAATGTGGACA|GGATTTATCGAAAGAACGCAGGAAGTGTCA
CCCAATAAGCGGAGCCGAAGATATCCGTTA|GGAGAACTTCGCCCGGTAGTATGACCGCGC
AACCCTCCTGTATCCCAAGGGCCCAGGCGG|GGAGCCGAAGATATCCGTTACGTAAACGTC
CGCGTTAAACATATCCCTATAGACAATAGT|GGCCAATAAGCGGAGCCGAAGATATCCGTT
CATAATTAGGTGAGTATGATGGCGATGGTA|GCGGAGCCGAAGATATCCGTTACTCGGACC
CAAGTCTGCATCTCCAATGCAGAGCCTTGA|GTTCGAGTTACGACAAATCGCAACGGGGTA
CATATCCCTATAGACAATAGTCTGGTATCG|GCGGAGCCGAAGATATCCGTTACCTTATCA
CTGGGGCCCTCAGTATTTTTTTAATGTGGA|ACGGATTTATCGAAAGAACGCAGGAAGTGT
AAGCCTCCTTCGTTAAATCTAATACTTTCG|CTTCCAATAAGCGGAGCCGAAGATATCCGT
TGTGCAGTCCAATAAGCGGAGCCGAAGATA|CTTTTCGCCAGATTCTTGTGCCTGTTGTAA
GCGGAGCCGAAGATATCCGTTACACTTCCA|TCGCCCGGTAGTATGACCGCGCAAGGTTTT
GGCCGTTGCCTACCATTGTGTACGTCGCGT|AGCCGAAGATATCCGTTACACAGATGGCCA
CGGAGCCGAAGATATCCGTTACACTTCCAA|CGCCCGGTAGTATGACCGCGCAAGGTTTTC
CCTGTTGTAACGTTTAATAACGGATTTATC|TGAGCAAAGGTTATCCACTGCCGCCAATAA
CGATAAAATACGCGCCCGGCGAAGCGAATT|TACATCCAACGCCCGACAAGGGATAATGCA
TCCGTTACACTTCCAATAAGCGGAGCCGAA|ACCGCGCAAGGTTTTCCAATAAGCGGAGCC
AGCCGAAGATATCCGTTACACAGATGGCCA|TTTCGTCCTGACCGTGCATAATTAGGTGAG
GCACTTTGCACGCCAATAAGCGGAGCCGAA|ACCAATAAGCGGAGCCGAAGATATCCGTTA
TTTTTAATGTGGACATCTGGATCGCTAGCG|ACGCAGGAAGTGTCAAGAACCTGCGGGAAC
CGGTAGTATGACCGCGCAAGGTTTTCCAAT|GATATCCGTTACTGGGCTGACGAGTTTTTT
ATAATTAGGTGAGTATGATGGCGATGGTAG|CGGAGCCGAAGATATCCGTTACTCGGACCG
ATACAAGACACATCTGCATTTACCAATAAG|AGTTGGAACGTTCTTTGTAGGCAGGCACCG
TTGCCCCAATAAGCGGAGCCGAAGATATCC|ATCCGTTACCCCAGTCCAGAAGCCTCCTTC
GCGGAGCCGAAGATATCCGTTCCAATAAGC|AGTCCAGAAGCCTCCTTCGTTAAATCTAAT
AGCGGAGCCGAAGATATCCCAATAAGCGGA|TTTCTAAGCGGGAAGCCAATAAGCGGAGCC
CATTTACCAATAAGCGGAGCCGAAGATATC|GTAGGCAGGCACCGACCGACGATCTGGTTT
TAAGCGGAGCCGAAGATATCCGTTCCAATA|CCCAGTCCAGAAGCCTCCTTCGTTAAATCT
ACATCTGCATTTACCAATAAGCGGAGCCGA|GTTCTTTGTAGGCAGGCACCGACCGACGAT
AAGCGGAGCCGAAGATATCCGTTACCGTTA|CGGAGCCGAAGATATCCGTTACAGCATACA
CCGTTACACAGAAATAGTCATGGCACTTTG|CATACAAGACACATCTGCATTTACCAATAA
CGCTAGCGGACCCAATAAGCGGAGCCGAAG|GCGGGAACAAACACGATAAAATACGCGCCC
ATATCCCTATAGACAATAGTCTGGTATCGA|CGGAGCCGAAGATATCCGTTACCTTATCAA
AAATACGCGCCCGGCGAAGCGAATTAGCAA|CCAACGCCCGACAAGGGATAATGCAAGGTT
AAATAGTCATGGCACTTTGCACGCCAATAA|CATCTGCATTTACCAATAAGCGGAGCCGAA
ATATCCGTTACACAGATGGCCAATAAGCGG|TGACCGTGCATAATTAGGTGAGTATGATGG
AGAACTTCGCCCGGTAGTATGACCGCGCAA|GCGGAGCCGAAGATATCCGTTACTGGGCTG
GCCGAAGATATCCGTTACCCCAGTCCAGAA|ATAAGCGGAGCCGAAGATATCCGTTACACT
AGCCGAAGATATCCGTTACCCCAATAAGCG|CGGAGCCGAAGATATCCCAATAAGCGGAGC
AGGCAGGCACCGACCGACGATCTGGTTTAT|CCGTTACCCTGGGGCCCTCAGTATTTTTTT
GATATCCGTTACCGTTACACAGAAATAGTC|ATCCGTTACAGCATACAAGACACATCTGCA
ATCCCAAGGGCCCAGGCGGCATGTGCAGTC|TATCCGTTACGTAAACGTCGTCTTTTCGCC
ACAATAGTCTGGTATCGAAGGGTAGTCAGC|TATCCGTTACCTTATCAACCAATAAGCGGA
CGAAGATATCCGTTACAACCACTGGGTACG|GATCTGGTTTATCGGCCATACAGGAATCCA
TAGCGGACCCAATAAGCGGAGCCGAAGATA|GGAACAAACACGATAAAATACGCGCCCGGC
TGGTGGCTATGGTGGATCGACAACTGAGTT|GGCCCAGGCGGCATGTGCAGTCCAATAAGC
TGCCGCCAATAAGCGGAGCCGAAGATATCC|CCCTCCAAAAATACGGCTACGAGAGAGTAG
GATAAAATACGCGCCCGGCGAAGCGAATTA|ACATCCAACGCCCGACAAGGGATAATGCAA
GCCGAAGATATCCGTTACTCGGACCGGCGG|AAGATATCCGTTACCGTTACACAGAAATAG
TTCGCCAGATTCTTGTGCCTGTTGTAACGT|TCTCCAATGCAGAGCCTTGAGCAAAGGTTA
CCTTCGTTAAATCTAATACTTTCGTCCTGA|ATAAGCGGAGCCGAAGATATCCGTTACCCC
CAATAAGCGGAGCCGAAGATATCCGTTACA|AAAAATACGGCTACGAGAGAGTAGGGCCCT
TGGATCGCTAGCGGACCCAATAAGCGGAGC|AACCTGCGGGAACAAACACGATAAAATACG
ATCGGCCATACAGGAATCCAGATCTTCATG|TTAATGTGGACATCTGGATCGCTAGCGGAC
GTCGTGCACGGGCCGTTGCCTACCATTGTG|CAATAAGCGGAGCCGAAGATATCCGTTACA
CCCGGTAGTATGACCGCGCAAGGTTTTCCA|AAGATATCCGTTACTGGGCTGACGAGTTTT
CGAAGATATCCGTTACGTAAACGTCGTCTT|CGCCCGGCGAAGCGAATTAGCAAGTCTGCA
GTTACCGTTACACAGAAATAGTCATGGCAC|ACAGCATACAAGACACATCTGCATTTACCA
GTTTATCGGCCATACAGGAATCCAGATCTT|TTTTTTAATGTGGACATCTGGATCGCTAGC
TCCGTTACCTTATCAACCAATAAGCGGAGC|GAGTCTAATAACACAAGATGCACCCCCAAT
CCGTTACCCCAGTCCAGAAGCCTCCTTCGT|CGAAGATATCCGTTACACTTCCAATAAGCG
ATAAGCGGAGCCGAAGATATCCGTTACAAC|CACCGACCGACGATCTGGTTTATCGGCCAT
GTTACACAGATGGCCAATAAGCGGAGCCGA|TGCATAATTAGGTGAGTATGATGGCGATGG
GAGCCGAAGATATCCGTTACCTTATCAACC|GCGATGGTAGGTGAGTCTAATAACACAAGA
GACACATCTGCATTTACCAATAAGCGGAGC|AACGTTCTTTGTAGGCAGGCACCGACCGAC
TCTGGTTTATCGGCCATACAGGAATCCAGA|GTATTTTTTTAATGTGGACATCTGGATCGC
GGACCCAATAAGCGGAGCCGAAGATATCCG|CAAACACGATAAAATACGCGCCCGGCGAAG
TTATCAACCAATAAGCGGAGCCGAAGATAT|AACACAAGATGCACCCCCAATAAGCGGAGC
AGATATCCGTTACTGGGCTGACGAGTTTTT|ACAACCACTGGGTACGCTGTAAGTGGACTC
AGTATGACCGCGCAAGGTTTTCCAATAAGC|TCCGTTACTGGGCTGACGAGTTTTTTCTTT
CATCACGGAGCCCACGCTACATCCAACGCC|AAAAATCACTCCCCCTACATCTTCCTCGTT
AAGCGGAGCCGAAGATATCCGTTACACTTC|CTTCGCCCGGTAGTATGACCGCGCAAGGTT
CCAATAAGCGGAGCCGAAGATATCCGTTAC|GATGCACCCCCAATAAGCGGAGCCGAAGAT
GATAAAACCTACCCCTCAATGGAGAACTTC|ATGGCACTTTGCACGCCAATAAGCGGAGCC
CTTCGTTAAATCTAATACTTTCGTCCTGAC|TAAGCGGAGCCGAAGATATCCGTTACCCCA
CGCCAATAAGCGGAGCCGAAGATATCCGTT|TCCAAAAATACGGCTACGAGAGAGTAGGGC
TACAGCATACAAGACACATCTGCATTTACC|CAACTGAGTTGGAACGTTCTTTGTAGGCAG
ACAACTGAGTTGGAACGTTCTTTGTAGGCA|GTCCAATAAGCGGAGCCGAAGATATCCGTT
TCTTTGTAGGCAGGCACCGACCGACGATCT|AAGATATCCGTTACCCTGGGGCCCTCAGTA
AAACATATCCCTATAGACAATAGTCTGGTA|TAAGCGGAGCCGAAGATATCCGTTACCTTA
GAAGATATCCGTTACCCCAATAAGCGGAGC|GCCGAAGATATCCCAATAAGCGGAGCCGAA
CGTAACGACTGAGTGAGAGTTTAACTGGTG|ATTCTAAACCCTCCTGTATCCCAAGGGCCC
AACTTCGCCCGGTAGTATGACCGCGCAAGG|GGAGCCGAAGATATCCGTTACTGGGCTGAC
AGCGAATTAGCAAGTCTGCATCTCCAATGC|ATAATGCAAGGTTCGAGTTACGACAAATCG
TACTTTCGTCCTGACCGTGCATAATTAGGT|ATATCCGTTACCCCAATAAGCGGAGCCGAA
CTTTCGTCCTGACCGTGCATAATTAGGTGA|ATCCGTTACCCCAATAAGCGGAGCCGAAGA
ATCGACAACTGAGTTGGAACGTTCTTTGTA|TGCAGTCCAATAAGCGGAGCCGAAGATATC
TCCAATAAGCGGAGCCGAAGATATCCGTTA|TAAATCTAATACTTTCGTCCTGACCGTGCA
GAAGCGAATTAGCAAGTCTGCATCTCCAAT|GGATAATGCAAGGTTCGAGTTACGACAAAT
TACCCCAATAAGCGGAGCCGAAGATATCCG|CCAATAAGCGGAGCCGAAGATATCCGTTAC
GTAGTCAGCTGTTACGGATTGCCCCAATAA|ATAAGCGGAGCCGAAGATATCCGTTACCCC
AACCACTGGGTACGCTGTAAGTGGACTCGT|CATACAGGAATCCAGATCTTCATGACTATT
GGTTTATCGGCCATACAGGAATCCAGATCT|TTTTTTTAATGTGGACATCTGGATCGCTAG
CGACGATCTGGTTTATCGGCCATACAGGAA|CCCTCAGTATTTTTTTAATGTGGACATCTG
ACCCCAGTCCAGAAGCCTCCTTCGTTAAAT|ATATCCGTTACACTTCCAATAAGCGGAGCC
GCAAGTCTGCATCTCCAATGCAGAGCCTTG|GGTTCGAGTTACGACAAATCGCAACGGGGT
CACAGATGGCCAATAAGCGGAGCCGAAGAT|TAATTAGGTGAGTATGATGGCGATGGTAGG
CGTTACACATCACGGAGCCCACGCTACATC|GGGCCCTAAAAATCACTCCCCCTACATCTT
AAGATATCCGTTACGTAAACGTCGTCTTTT|CCCGGCGAAGCGAATTAGCAAGTCTGCATC
AATGGAGAACTTCGCCCGGTAGTATGACCG|AATAAGCGGAGCCGAAGATATCCGTTACTG
ACCCTCCTGTATCCCAAGGGCCCAGGCGGC|GAGCCGAAGATATCCGTTACGTAAACGTCG
TGTAGGCAGGCACCGACCGACGATCTGGTT|TATCCGTTACCCTGGGGCCCTCAGTATTTT
CCAATAAGCGGAGCCGAAGATATCCCAATA|TTTTTCTTTCTAAGCGGGAAGCCAATAAGC
TTACACTTCCAATAAGCGGAGCCGAAGATA|CGCAAGGTTTTCCAATAAGCGGAGCCGAAG
CAATAAGCGGAGCCGAAGATATCCGTTACG|ACGATAAAATACGCGCCCGGCGAAGCGAAT
CTGAGTTGGAACGTTCTTTGTAGGCAGGCA|AATAAGCGGAGCCGAAGATATCCGTTACCC
ATATCCGTTACACTTCCAATAAGCGGAGCC|ATGACCGCGCAAGGTTTTCCAATAAGCGGA
TTTATCGAAAGAACGCAGGAAGTGTCAAGA|CAATAAGCGGAGCCGAAGATATCCGTTACA
AGAAATAGTCATGGCACTTTGCACGCCAAT|CACATCTGCATTTACCAATAAGCGGAGCCG
ACCCCTCAATGGAGAACTTCGCCCGGTAGT|GCACGCCAATAAGCGGAGCCGAAGATATCC
GTGTCAAGAACCTGCGGGAACAAACACGAT|TCCGTTACACATCACGGAGCCCACGCTACA
CGCCAGATTCTTGTGCCTGTTGTAACGTTT|TCCAATGCAGAGCCTTGAGCAAAGGTTATC
ATGGTAGGTGAGTCTAATAACACAAGATGC|CGGACCGGCGGCAGATAAAACCTACCCCTC
AGGTGAGTATGATGGCGATGGTAGGTGAGT|CGAAGATATCCGTTACTCGGACCGGCGGCA
CCGAAGATATCCCAATAAGCGGAGCCGAAG|GCGGGAAGCCAATAAGCGGAGCCGAAGATA
TAGGCAGGCACCGACCGACGATCTGGTTTA|TCCGTTACCCTGGGGCCCTCAGTATTTTTT
GCCGCCAATAAGCGGAGCCGAAGATATCCG|CCTCCAAAAATACGGCTACGAGAGAGTAGG
TATCCGTTACGTAAACGTCGTCTTTTCGCC|GCGAAGCGAATTAGCAAGTCTGCATCTCCA
TGGTAGGTGAGTCTAATAACACAAGATGCA|GGACCGGCGGCAGATAAAACCTACCCCTCA
TAGTATGACCGCGCAAGGTTTTCCAATAAG|ATCCGTTACTGGGCTGACGAGTTTTTTCTT
ACTCGTAACGACTGAGTGAGAGTTTAACTG|ACTATTCTAAACCCTCCTGTATCCCAAGGG
ATAAGCGGAGCCGAAGATATCCGTTACGTA|GATAAAATACGCGCCCGGCGAAGCGAATTA
GGGTACGCTGTAAGTGGACTCGTAACGACT|GAATCCAGATCTTCATGACTATTCTAAACC
GCCCGGCGAAGCGAATTAGCAAGTCTGCAT|CGACAAGGGATAATGCAAGGTTCGAGTTAC
TGGCACTTTGCACGCCAATAAGCGGAGCCG|TTACCAATAAGCGGAGCCGAAGATATCCGT
ACGTCGTCTTTTCGCCAGATTCTTGTGCCT|CAAGTCTGCATCTCCAATGCAGAGCCTTGA
TGGGCTGACGAGTTTTTTCTTTCTAAGCGG|ACGCTGTAAGTGGACTCGTAACGACTGAGT
AAGCGGAGCCGAAGATATCCGTTACGTAAA|TAAAATACGCGCCCGGCGAAGCGAATTAGC
CTACCCCTCAATGGAGAACTTCGCCCGGTA|TTGCACGCCAATAAGCGGAGCCGAAGATAT
GGTACGCTGTAAGTGGACTCGTAACGACTG|AATCCAGATCTTCATGACTATTCTAAACCC
TACCAATAAGCGGAGCCGAAGATATCCGTT|GCAGGCACCGACCGACGATCTGGTTTATCG
CGATGGTAGGTGAGTCTAATAACACAAGAT|CTCGGACCGGCGGCAGATAAAACCTACCCC
TACACATCACGGAGCCCACGCTACATCCAA|CCCTAAAAATCACTCCCCCTACATCTTCCT
CCGTGCATAATTAGGTGAGTATGATGGCGA|AATAAGCGGAGCCGAAGATATCCGTTACTC
AGTTTTTTCTTTCTAAGCGGGAAGCCAATA|TGGACTCGTAACGACTGAGTGAGAGTTTAA
AGCGGAGCCGAAGATATCCGTTACCGTTAC|GGAGCCGAAGATATCCGTTACAGCATACAA
AATGCAGAGCCTTGAGCAAAGGTTATCCAC|AATCGCAACGGGGTATCTTCCGGTGGGCCA
CCGAAGATATCCGTTACGTAAACGTCGTCT|GCGCCCGGCGAAGCGAATTAGCAAGTCTGC
CGGAGCCGAAGATATCCGTTACACATCACG|CGGCTACGAGAGAGTAGGGCCCTAAAAATC
CCGTTACCCCAATAAGCGGAGCCGAAGATA|TATCCCAATAAGCGGAGCCGAAGATATCCG
TGGACATCTGGATCGCTAGCGGACCCAATA|GTGTCAAGAACCTGCGGGAACAAACACGAT
CGTTACACAGAAATAGTCATGGCACTTTGC|ATACAAGACACATCTGCATTTACCAATAAG
AATAAGCGGAGCCGAAGATATCCGTTACAC|GAACTTCGCCCGGTAGTATGACCGCGCAAG
GCCGAAGATATCCGTTACACATCACGGAGC|TACGAGAGAGTAGGGCCCTAAAAATCACTC
GAACGTTCTTTGTAGGCAGGCACCGACCGA|GAGCCGAAGATATCCGTTACCCTGGGGCCC
GCGGAGCCGAAGATATCCGTTACCGTTACA|GAGCCGAAGATATCCGTTACAGCATACAAG
ACTTCCAATAAGCGGAGCCGAAGATATCCG|AGGTTTTCCAATAAGCGGAGCCGAAGATAT
GTTACACTTCCAATAAGCGGAGCCGAAGAT|GCGCAAGGTTTTCCAATAAGCGGAGCCGAA
GTCGTCTTTTCGCCAGATTCTTGTGCCTGT|AGTCTGCATCTCCAATGCAGAGCCTTGAGC
ACGAGTTTTTTCTTTCTAAGCGGGAAGCCA|AAGTGGACTCGTAACGACTGAGTGAGAGTT
TAAGCGGAGCCGAAGATATCCGTTACCCCA|CACCCCCAATAAGCGGAGCCGAAGATATCC
TGTTACGGATTGCCCCAATAAGCGGAGCCG|GCCGAAGATATCCGTTACCCCAGTCCAGAA
AGCGGAGCCGAAGATATCCGTTACAGCATA|CTGGTGGCTATGGTGGATCGACAACTGAGT
CAATAAGCGGAGCCGAAGATATCCGTTACT|AAGCGGAGCCGAAGATATCCGTTACCGTTA
AATAAGCGGAGCCGAAGATATCCGTTACCC|GATTCTTGTGCCTGTTGTAACGTTTAATAA
TCGCCCGGTAGTATGACCGCGCAAGGTTTT|CCGAAGATATCCGTTACTGGGCTGACGAGT
GGGCCCAGGCGGCATGTGCAGTCCAATAAG|TACGTAAACGTCGTCTTTTCGCCAGATTCT
CCCTGGGGCCCTCAGTATTTTTTTAATGTG|TAACGGATTTATCGAAAGAACGCAGGAAGT
GGTGGCTATGGTGGATCGACAACTGAGTTG|GCCCAGGCGGCATGTGCAGTCCAATAAGCG
GAAGATATCCGTTACCCCAGTCCAGAAGCC|AGCGGAGCCGAAGATATCCGTTACACTTCC
AAGCCAATAAGCGGAGCCGAAGATATCCGT|AGAGTTTAACTGGTGGCTATGGTGGATCGA
AGCGGAGCCGAAGATATCCGTTACCCCAGT|CCCCCAATAAGCGGAGCCGAAGATATCCGT
GCATAATTAGGTGAGTATGATGGCGATGGT|AGCGGAGCCGAAGATATCCGTTACTCGGAC
GCGGAGCCGAAGATATCCCAATAAGCGGAG|TTCTAAGCGGGAAGCCAATAAGCGGAGCCG
TACGGATTGCCCCAATAAGCGGAGCCGAAG|GAAGATATCCGTTACCCCAGTCCAGAAGCC
TAAAACCTACCCCTCAATGGAGAACTTCGC|GGCACTTTGCACGCCAATAAGCGGAGCCGA
CAACTGAGTTGGAACGTTCTTTGTAGGCAG|TCCAATAAGCGGAGCCGAAGATATCCGTTA
GAAATAGTCATGGCACTTTGCACGCCAATA|ACATCTGCATTTACCAATAAGCGGAGCCGA
TGGACTCGTAACGACTGAGTGAGAGTTTAA|ATGACTATTCTAAACCCTCCTGTATCCCAA
GAGCCGAAGATATCCGTTACAGCATACAAG|TGGCTATGGTGGATCGACAACTGAGTTGGA
ATATCCGTTACGTAAACGTCGTCTTTTCGC|GGCGAAGCGAATTAGCAAGTCTGCATCTCC
GCGGGAACAAACACGATAAAATACGCGCCC|ACGGAGCCCACGCTACATCCAACGCCCGAC
ACGACTGAGTGAGAGTTTAACTGGTGGCTA|TAAACCCTCCTGTATCCCAAGGGCCCAGGC
TCTAAACCCTCCTGTATCCCAAGGGCCCAG|AAGCGGAGCCGAAGATATCCGTTACGTAAA
AGGAAGTGTCAAGAACCTGCGGGAACAAAC|AGATATCCGTTACACATCACGGAGCCCACG
ACATCACGGAGCCCACGCTACATCCAACGC|TAAAAATCACTCCCCCTACATCTTCCTCGT
AGGTTATCCACTGCCGCCAATAAGCGGAGC|CCGGTGGGCCACCCTCCAAAAATACGGCTA
CCCAGTCCAGAAGCCTCCTTCGTTAAATCT|ATCCGTTACACTTCCAATAAGCGGAGCCGA
GGAGCCGAAGATATCCGTTACAGCATACAA|GTGGCTATGGTGGATCGACAACTGAGTTGG
ATGGTGGATCGACAACTGAGTTGGAACGTT|CGGCATGTGCAGTCCAATAAGCGGAGCCGA
TCCAGATCTTCATGACTATTCTAAACCCTC|GATCGCTAGCGGACCCAATAAGCGGAGCCG
CTTTCTAAGCGGGAAGCCAATAAGCGGAGC|TAACGACTGAGTGAGAGTTTAACTGGTGGC
TACGCGCCCGGCGAAGCGAATTAGCAAGTC|ACGCCCGACAAGGGATAATGCAAGGTTCGA
AACGTCGTCTTTTCGCCAGATTCTTGTGCC|GCAAGTCTGCATCTCCAATGCAGAGCCTTG
GTCATGGCACTTTGCACGCCAATAAGCGGA|GCATTTACCAATAAGCGGAGCCGAAGATAT
GGGGGTCGTGCACGGGCCGTTGCCTACCAT|GTTCCAATAAGCGGAGCCGAAGATATCCGT
CGAAGATATCCCAATAAGCGGAGCCGAAGA|CGGGAAGCCAATAAGCGGAGCCGAAGATAT
AGCGGAGCCGAAGATATCCGTTACTCGGAC|GAGCCGAAGATATCCGTTACCGTTACACAG
TGGTTTATCGGCCATACAGGAATCCAGATC|ATTTTTTTAATGTGGACATCTGGATCGCTA
AGCAAGTCTGCATCTCCAATGCAGAGCCTT|AGGTTCGAGTTACGACAAATCGCAACGGGG
GCCGAAGATATCCGTTACACTTCCAATAAG|CGGTAGTATGACCGCGCAAGGTTTTCCAAT
TTAAACATATCCCTATAGACAATAGTCTGG|AATAAGCGGAGCCGAAGATATCCGTTACCT
CTAGCGGACCCAATAAGCGGAGCCGAAGAT|GGGAACAAACACGATAAAATACGCGCCCGG
CCAAGGGGGTCGTGCACGGGCCGTTGCCTA|ATCCGTTCCAATAAGCGGAGCCGAAGATAT
GTTGTAACGTTTAATAACGGATTTATCGAA|GCAAAGGTTATCCACTGCCGCCAATAAGCG
CGGGAACAAACACGATAAAATACGCGCCCG|CGGAGCCCACGCTACATCCAACGCCCGACA
GAATTAGCAAGTCTGCATCTCCAATGCAGA|ATGCAAGGTTCGAGTTACGACAAATCGCAA
ATCCGTTACACAGATGGCCAATAAGCGGAG|ACCGTGCATAATTAGGTGAGTATGATGGCG
CACCGACCGACGATCTGGTTTATCGGCCAT|CCTGGGGCCCTCAGTATTTTTTTAATGTGG
GCCTCCTTCGTTAAATCTAATACTTTCGTC|TCCAATAAGCGGAGCCGAAGATATCCGTTA
CCAGGCGGCATGTGCAGTCCAATAAGCGGA|TAAACGTCGTCTTTTCGCCAGATTCTTGTG
TTGCCTACCATTGTGTACGTCGCGTTAAAC|AAGATATCCGTTACACAGATGGCCAATAAG
TAAATCTAATACTTTCGTCCTGACCGTGCA|GAGCCGAAGATATCCGTTACCCCAATAAGC
CCGAAGATATCCGTTACCGTTACACAGAAA|AAGATATCCGTTACAGCATACAAGACACAT
GCCGAAGATATCCGTTACCCTGGGGCCCTC|CCTGTTGTAACGTTTAATAACGGATTTATC
TCGTAACGACTGAGTGAGAGTTTAACTGGT|TATTCTAAACCCTCCTGTATCCCAAGGGCC
TCTCCAATGCAGAGCCTTGAGCAAAGGTTA|CGACAAATCGCAACGGGGTATCTTCCGGTG
CCGTTACCTTATCAACCAATAAGCGGAGCC|AGTCTAATAACACAAGATGCACCCCCAATA
GCACCGACCGACGATCTGGTTTATCGGCCA|CCCTGGGGCCCTCAGTATTTTTTTAATGTG
AGATATCCGTTACCGTTACACAGAAATAGT|TATCCGTTACAGCATACAAGACACATCTGC
GTGCCTGTTGTAACGTTTAATAACGGATTT|CCTTGAGCAAAGGTTATCCACTGCCGCCAA
AAGTGGACTCGTAACGACTGAGTGAGAGTT|TTCATGACTATTCTAAACCCTCCTGTATCC
ATCTGGATCGCTAGCGGACCCAATAAGCGG|AAGAACCTGCGGGAACAAACACGATAAAAT
AGCAAAGGTTATCCACTGCCGCCAATAAGC|ATCTTCCGGTGGGCCACCCTCCAAAAATAC
TTTTTTTAATGTGGACATCTGGATCGCTAG|GAACGCAGGAAGTGTCAAGAACCTGCGGGA
AGCCAATAAGCGGAGCCGAAGATATCCGTT|GAGTTTAACTGGTGGCTATGGTGGATCGAC
CCGAAGATATCCGTTACACAGATGGCCAAT|TCGTCCTGACCGTGCATAATTAGGTGAGTA
AGCCGAAGATATCCGTTACCCTGGGGCCCT|GCCTGTTGTAACGTTTAATAACGGATTTAT
AACGACTGAGTGAGAGTTTAACTGGTGGCT|CTAAACCCTCCTGTATCCCAAGGGCCCAGG
CAGTCCAGAAGCCTCCTTCGTTAAATCTAA|CCGTTACACTTCCAATAAGCGGAGCCGAAG
CGGACCCAATAAGCGGAGCCGAAGATATCC|ACAAACACGATAAAATACGCGCCCGGCGAA
GTAGGTGAGTCTAATAACACAAGATGCACC|ACCGGCGGCAGATAAAACCTACCCCTCAAT
CCGTTACTCGGACCGGCGGCAGATAAAACC|TACCGTTACACAGAAATAGTCATGGCACTT
CATTGTGTACGTCGCGTTAAACATATCCCT|CGTTACACAGATGGCCAATAAGCGGAGCCG
TAAGCGGAGCCGAAGATATCCGTTACACTT|ACTTCGCCCGGTAGTATGACCGCGCAAGGT
CGTTACCCTGGGGCCCTCAGTATTTTTTTA|TTTAATAACGGATTTATCGAAAGAACGCAG
GCAGATAAAACCTACCCCTCAATGGAGAAC|GTCATGGCACTTTGCACGCCAATAAGCGGA
CGTTACTGGGCTGACGAGTTTTTTCTTTCT|CTGGGTACGCTGTAAGTGGACTCGTAACGA
GTTACTCGGACCGGCGGCAGATAAAACCTA|CCGTTACACAGAAATAGTCATGGCACTTTG
TAAGCGGAGCCGAAGATATCCGTTACGTAA|ATAAAATACGCGCCCGGCGAAGCGAATTAG
CCAATAAGCGGAGCCGAAGATATCCGTTAC|AGCCGAAGATATCCGTTACAACCACTGGGT
CCAAGGGCCCAGGCGGCATGTGCAGTCCAA|CCGTTACGTAAACGTCGTCTTTTCGCCAGA
GATATCCGTTACCCTGGGGCCCTCAGTATT|GTAACGTTTAATAACGGATTTATCGAAAGA
CCAGAAGCCTCCTTCGTTAAATCTAATACT|TACACTTCCAATAAGCGGAGCCGAAGATAT
GATGGCGATGGTAGGTGAGTCTAATAACAC|CGTTACTCGGACCGGCGGCAGATAAAACCT
GGAGCCGAAGATATCCGTTACCTTATCAAC|GGCGATGGTAGGTGAGTCTAATAACACAAG
TTTCGCCAGATTCTTGTGCCTGTTGTAACG|ATCTCCAATGCAGAGCCTTGAGCAAAGGTT
GGGTCGTGCACGGGCCGTTGCCTACCATTG|TCCAATAAGCGGAGCCGAAGATATCCGTTA
TCTTGTGCCTGTTGTAACGTTTAATAACGG|AGAGCCTTGAGCAAAGGTTATCCACTGCCG
CCGAAGATATCCGTTACCCCAGTCCAGAAG|TAAGCGGAGCCGAAGATATCCGTTACACTT
AAGATATCCCAATAAGCGGAGCCGAAGATA|GGAAGCCAATAAGCGGAGCCGAAGATATCC
TATCCGTTACACATCACGGAGCCCACGCTA|AGTAGGGCCCTAAAAATCACTCCCCCTACA
CGTTAAACATATCCCTATAGACAATAGTCT|CCAATAAGCGGAGCCGAAGATATCCGTTAC
GATCTTCATGACTATTCTAAACCCTCCTGT|GCTAGCGGACCCAATAAGCGGAGCCGAAGA
AGATCTTCATGACTATTCTAAACCCTCCTG|CGCTAGCGGACCCAATAAGCGGAGCCGAAG
CAACCAATAAGCGGAGCCGAAGATATCCGT|CAAGATGCACCCCCAATAAGCGGAGCCGAA
ACCTACCCCTCAATGGAGAACTTCGCCCGG|CTTTGCACGCCAATAAGCGGAGCCGAAGAT
ATCACGGAGCCCACGCTACATCCAACGCCC|AAAATCACTCCCCCTACATCTTCCTCGTTC
CGCAGGAAGTGTCAAGAACCTGCGGGAACA|CGAAGATATCCGTTACACATCACGGAGCCC
TACAACCACTGGGTACGCTGTAAGTGGACT|GGCCATACAGGAATCCAGATCTTCATGACT
TTGGAACGTTCTTTGTAGGCAGGCACCGAC|GCGGAGCCGAAGATATCCGTTACCCTGGGG
GCAAGGTTTTCCAATAAGCGGAGCCGAAGA|GCTGACGAGTTTTTTCTTTCTAAGCGGGAA
CACGGGCCGTTGCCTACCATTGTGTACGTC|GCGGAGCCGAAGATATCCGTTACACAGATG
AGCGGAGCCGAAGATATCCGTTACCTTATC|GATGGCGATGGTAGGTGAGTCTAATAACAC
CAGGCGGCATGTGCAGTCCAATAAGCGGAG|AAACGTCGTCTTTTCGCCAGATTCTTGTGC
ACCCCCAATAAGCGGAGCCGAAGATATCCG|AATGGAGAACTTCGCCCGGTAGTATGACCG
AGATATCCGTTACACTTCCAATAAGCGGAG|GTATGACCGCGCAAGGTTTTCCAATAAGCG
CGGAGCCGAAGATATCCGTTACACAGATGG|TACTTTCGTCCTGACCGTGCATAATTAGGT
ACCCTGGGGCCCTCAGTATTTTTTTAATGT|ATAACGGATTTATCGAAAGAACGCAGGAAG
GTTGGAACGTTCTTTGTAGGCAGGCACCGA|AGCGGAGCCGAAGATATCCGTTACCCTGGG
TAGTCATGGCACTTTGCACGCCAATAAGCG|CTGCATTTACCAATAAGCGGAGCCGAAGAT
ATATCCGTTACAACCACTGGGTACGCTGTA|GGTTTATCGGCCATACAGGAATCCAGATCT
TTCCAATAAGCGGAGCCGAAGATATCCGTT|TTAAATCTAATACTTTCGTCCTGACCGTGC
GGTGAGTATGATGGCGATGGTAGGTGAGTC|GAAGATATCCGTTACTCGGACCGGCGGCAG
ATAAGCGGAGCCGAAGATATCCCAATAAGC|TTCTTTCTAAGCGGGAAGCCAATAAGCGGA
CCGTTACAGCATACAAGACACATCTGCATT|TCGACAACTGAGTTGGAACGTTCTTTGTAG
CAAAGGTTATCCACTGCCGCCAATAAGCGG|CTTCCGGTGGGCCACCCTCCAAAAATACGG
ATCCGTTACAACCACTGGGTACGCTGTAAG|TTTATCGGCCATACAGGAATCCAGATCTTC
CCTCAATGGAGAACTTCGCCCGGTAGTATG|CGCCAATAAGCGGAGCCGAAGATATCCGTT
AGGGCCCAGGCGGCATGTGCAGTCCAATAA|TTACGTAAACGTCGTCTTTTCGCCAGATTC
GAGTTGGAACGTTCTTTGTAGGCAGGCACC|TAAGCGGAGCCGAAGATATCCGTTACCCTG
GTCTAATAACACAAGATGCACCCCCAATAA|CAGATAAAACCTACCCCTCAATGGAGAACT
TAACGTTTAATAACGGATTTATCGAAAGAA|AGGTTATCCACTGCCGCCAATAAGCGGAGC
CGTCGCGTTAAACATATCCCTATAGACAAT|GATGGCCAATAAGCGGAGCCGAAGATATCC
ACATATCCCTATAGACAATAGTCTGGTATC|AGCGGAGCCGAAGATATCCGTTACCTTATC
CTTTGCACGCCAATAAGCGGAGCCGAAGAT|AATAAGCGGAGCCGAAGATATCCGTTACAA
CGGGCCGTTGCCTACCATTGTGTACGTCGC|GGAGCCGAAGATATCCGTTACACAGATGGC
ATGGAGAACTTCGCCCGGTAGTATGACCGC|ATAAGCGGAGCCGAAGATATCCGTTACTGG
GAACTTCGCCCGGTAGTATGACCGCGCAAG|CGGAGCCGAAGATATCCGTTACTGGGCTGA
CAGCTGTTACGGATTGCCCCAATAAGCGGA|CGGAGCCGAAGATATCCGTTACCCCAGTCC
CGTTACGTAAACGTCGTCTTTTCGCCAGAT|AGCGAATTAGCAAGTCTGCATCTCCAATGC
GGACCGGCGGCAGATAAAACCTACCCCTCA|ACAGAAATAGTCATGGCACTTTGCACGCCA
CTCCTGTATCCCAAGGGCCCAGGCGGCATG|CCGAAGATATCCGTTACGTAAACGTCGTCT
TGAGTCTAATAACACAAGATGCACCCCCAA|CGGCAGATAAAACCTACCCCTCAATGGAGA
CGAAGATATCCGTTACTGGGCTGACGAGTT|GTTACAACCACTGGGTACGCTGTAAGTGGA
CACTGCCGCCAATAAGCGGAGCCGAAGATA|CCACCCTCCAAAAATACGGCTACGAGAGAG
ATATCCGTTACACATCACGGAGCCCACGCT|GAGTAGGGCCCTAAAAATCACTCCCCCTAC
GGCGGCAGATAAAACCTACCCCTCAATGGA|AATAGTCATGGCACTTTGCACGCCAATAAG
CAGGAATCCAGATCTTCATGACTATTCTAA|CATCTGGATCGCTAGCGGACCCAATAAGCG
AATTAGGTGAGTATGATGGCGATGGTAGGT|GAGCCGAAGATATCCGTTACTCGGACCGGC
GCATACAAGACACATCTGCATTTACCAATA|TGAGTTGGAACGTTCTTTGTAGGCAGGCAC
TTAACTGGTGGCTATGGTGGATCGACAACT|CCAAGGGCCCAGGCGGCATGTGCAGTCCAA
AACCTGCGGGAACAAACACGATAAAATACG|ACATCACGGAGCCCACGCTACATCCAACGC
GAGCCGAAGATATCCGTTACGTAAACGTCG|TACGCGCCCGGCGAAGCGAATTAGCAAGTC
AGCCGAAGATATCCGTTACCCCAGTCCAGA|AATAAGCGGAGCCGAAGATATCCGTTACAC
AACCAATAAGCGGAGCCGAAGATATCCGTT|AAGATGCACCCCCAATAAGCGGAGCCGAAG
GTTACAGCATACAAGACACATCTGCATTTA|GACAACTGAGTTGGAACGTTCTTTGTAGGC
TTTTAATGTGGACATCTGGATCGCTAGCGG|CGCAGGAAGTGTCAAGAACCTGCGGGAACA
GGGGTCGTGCACGGGCCGTTGCCTACCATT|TTCCAATAAGCGGAGCCGAAGATATCCGTT
AAGCGGAGCCGAAGATATCCGTTACACATC|ATACGGCTACGAGAGAGTAGGGCCCTAAAA
TTTGCACGCCAATAAGCGGAGCCGAAGATA|ATAAGCGGAGCCGAAGATATCCGTTACAAC
TGTACGTCGCGTTAAACATATCCCTATAGA|CACAGATGGCCAATAAGCGGAGCCGAAGAT
CGAAGATATCCGTTACCTTATCAACCAATA|TGGTAGGTGAGTCTAATAACACAAGATGCA
CGGAGCCGAAGATATCCGTTACCCCAGTCC|CCCAATAAGCGGAGCCGAAGATATCCGTTA
TTACTGGGCTGACGAGTTTTTTCTTTCTAA|GGGTACGCTGTAAGTGGACTCGTAACGACT
TTAGGTGAGTATGATGGCGATGGTAGGTGA|GCCGAAGATATCCGTTACTCGGACCGGCGG
TTGTAGGCAGGCACCGACCGACGATCTGGT|ATATCCGTTACCCTGGGGCCCTCAGTATTT
CCGAAGATATCCGTTACACATCACGGAGCC|ACGAGAGAGTAGGGCCCTAAAAATCACTCC
TCGTCCTGACCGTGCATAATTAGGTGAGTA|CGTTACCCCAATAAGCGGAGCCGAAGATAT
TGGATCGACAACTGAGTTGGAACGTTCTTT|ATGTGCAGTCCAATAAGCGGAGCCGAAGAT
GTGCAGTCCAATAAGCGGAGCCGAAGATAT|TTTTCGCCAGATTCTTGTGCCTGTTGTAAC
AGCGGAGCCGAAGATATCCGTTACCCTGGG|CTTGTGCCTGTTGTAACGTTTAATAACGGA
CAAACACGATAAAATACGCGCCCGGCGAAG|CCACGCTACATCCAACGCCCGACAAGGGAT
TGAGTTGGAACGTTCTTTGTAGGCAGGCAC|ATAAGCGGAGCCGAAGATATCCGTTACCCT
TTGTGCCTGTTGTAACGTTTAATAACGGAT|AGCCTTGAGCAAAGGTTATCCACTGCCGCC
AGTCTAATAACACAAGATGCACCCCCAATA|GCAGATAAAACCTACCCCTCAATGGAGAAC
TATCCGTTACTCGGACCGGCGGCAGATAAA|CGTTACCGTTACACAGAAATAGTCATGGCA
ACGTAAACGTCGTCTTTTCGCCAGATTCTT|AATTAGCAAGTCTGCATCTCCAATGCAGAG
TATCGAAGGGTAGTCAGCTGTTACGGATTG|TATCAACCAATAAGCGGAGCCGAAGATATC
CGAAGATATCCGTTACTCGGACCGGCGGCA|GATATCCGTTACCGTTACACAGAAATAGTC
GCGGAGCCGAAGATATCCGTTACCTTATCA|ATGGCGATGGTAGGTGAGTCTAATAACACA
TATCCCAATAAGCGGAGCCGAAGATATCCG|GCCAATAAGCGGAGCCGAAGATATCCGTTA
CCCCCAATAAGCGGAGCCGAAGATATCCGT|ATGGAGAACTTCGCCCGGTAGTATGACCGC
TTGCACGCCAATAAGCGGAGCCGAAGATAT|TAAGCGGAGCCGAAGATATCCGTTACAACC
GCCGAAGATATCCGTTACAGCATACAAGAC|GCTATGGTGGATCGACAACTGAGTTGGAAC
GGAGAACTTCGCCCGGTAGTATGACCGCGC|AAGCGGAGCCGAAGATATCCGTTACTGGGC
GTGAGTATGATGGCGATGGTAGGTGAGTCT|AAGATATCCGTTACTCGGACCGGCGGCAGA
GGAGCCGAAGATATCCGTTACACAGATGGC|ACTTTCGTCCTGACCGTGCATAATTAGGTG
CATGTGCAGTCCAATAAGCGGAGCCGAAGA|GTCTTTTCGCCAGATTCTTGTGCCTGTTGT
CTGCATCTCCAATGCAGAGCCTTGAGCAAA|AGTTACGACAAATCGCAACGGGGTATCTTC
CTTCGCCCGGTAGTATGACCGCGCAAGGTT|AGCCGAAGATATCCGTTACTGGGCTGACGA
AAACCCTCCTGTATCCCAAGGGCCCAGGCG|CGGAGCCGAAGATATCCGTTACGTAAACGT
GAAGATATCCGTTACACTTCCAATAAGCGG|TAGTATGACCGCGCAAGGTTTTCCAATAAG
CGGATTTATCGAAAGAACGCAGGAAGTGTC|CCGCCAATAAGCGGAGCCGAAGATATCCGT
GCCGTTGCCTACCATTGTGTACGTCGCGTT|GCCGAAGATATCCGTTACACAGATGGCCAA
ATCCGTTACTCGGACCGGCGGCAGATAAAA|GTTACCGTTACACAGAAATAGTCATGGCAC
AGGTTTTCCAATAAGCGGAGCCGAAGATAT|GACGAGTTTTTTCTTTCTAAGCGGGAAGCC
TCAGTATTTTTTTAATGTGGACATCTGGAT|TCGAAAGAACGCAGGAAGTGTCAAGAACCT
AAGATATCCGTTACACATCACGGAGCCCAC|AGAGAGTAGGGCCCTAAAAATCACTCCCCC
AATAAGCGGAGCCGAAGATATCCGTTCCAA|ACCCCAGTCCAGAAGCCTCCTTCGTTAAAT
GGCCAATAAGCGGAGCCGAAGATATCCGTT|GTGAGTATGATGGCGATGGTAGGTGAGTCT
AACACGATAAAATACGCGCCCGGCGAAGCG|ACGCTACATCCAACGCCCGACAAGGGATAA
ATCCGTTACCCTGGGGCCCTCAGTATTTTT|ACGTTTAATAACGGATTTATCGAAAGAACG
TTCCAATAAGCGGAGCCGAAGATATCCGTT|GTTTTCCAATAAGCGGAGCCGAAGATATCC
AGTTTAACTGGTGGCTATGGTGGATCGACA|ATCCCAAGGGCCCAGGCGGCATGTGCAGTC
AGCGGAGCCGAAGATATCCGTTACACAGAT|AATACTTTCGTCCTGACCGTGCATAATTAG
AGCCGAAGATATCCGTTACAACCACTGGGT|GACGATCTGGTTTATCGGCCATACAGGAAT
AGCCTCCTTCGTTAAATCTAATACTTTCGT|TTCCAATAAGCGGAGCCGAAGATATCCGTT
ATAAAATACGCGCCCGGCGAAGCGAATTAG|CATCCAACGCCCGACAAGGGATAATGCAAG
CACAGAAATAGTCATGGCACTTTGCACGCC|AGACACATCTGCATTTACCAATAAGCGGAG
TGACTATTCTAAACCCTCCTGTATCCCAAG|ACCCAATAAGCGGAGCCGAAGATATCCGTT
AGCCGAAGATATCCGTTACACATCACGGAG|CTACGAGAGAGTAGGGCCCTAAAAATCACT
TGAGAGTTTAACTGGTGGCTATGGTGGATC|CTGTATCCCAAGGGCCCAGGCGGCATGTGC
GGGAAGCCAATAAGCGGAGCCGAAGATATC|GTGAGAGTTTAACTGGTGGCTATGGTGGAT
AGATATCCGTTACACATCACGGAGCCCACG|GAGAGTAGGGCCCTAAAAATCACTCCCCCT
ATAAGCGGAGCCGAAGATATCCGTTACTCG|GCGGAGCCGAAGATATCCGTTACCGTTACA
GATCTGGTTTATCGGCCATACAGGAATCCA|CAGTATTTTTTTAATGTGGACATCTGGATC
GCGGAGCCGAAGATATCCGTTACCCCAGTC|CCCCAATAAGCGGAGCCGAAGATATCCGTT
CGCGCAAGGTTTTCCAATAAGCGGAGCCGA|TGGGCTGACGAGTTTTTTCTTTCTAAGCGG
CAATAAGCGGAGCCGAAGATATCCGTTACC|TAAGCGGAGCCGAAGATATCCGTTACAGCA
TGCCCCAATAAGCGGAGCCGAAGATATCCG|TCCGTTACCCCAGTCCAGAAGCCTCCTTCG
AGCCGAAGATATCCCAATAAGCGGAGCCGA|AAGCGGGAAGCCAATAAGCGGAGCCGAAGA
TATCCGTTACACTTCCAATAAGCGGAGCCG|TGACCGCGCAAGGTTTTCCAATAAGCGGAG
CGTTACTCGGACCGGCGGCAGATAAAACCT|ACCGTTACACAGAAATAGTCATGGCACTTT
TCTTTCTAAGCGGGAAGCCAATAAGCGGAG|GTAACGACTGAGTGAGAGTTTAACTGGTGG
TGCCTACCATTGTGTACGTCGCGTTAAACA|AGATATCCGTTACACAGATGGCCAATAAGC
ATGCACCCCCAATAAGCGGAGCCGAAGATA|CCTCAATGGAGAACTTCGCCCGGTAGTATG
AACAAACACGATAAAATACGCGCCCGGCGA|GCCCACGCTACATCCAACGCCCGACAAGGG
CTGTATCCCAAGGGCCCAGGCGGCATGTGC|AAGATATCCGTTACGTAAACGTCGTCTTTT
TCGGACCGGCGGCAGATAAAACCTACCCCT|ACACAGAAATAGTCATGGCACTTTGCACGC
TCCGTTACTGGGCTGACGAGTTTTTTCTTT|CACTGGGTACGCTGTAAGTGGACTCGTAAC
GCGGAGCCGAAGATATCCGTTACTGGGCTG|GATATCCGTTACAACCACTGGGTACGCTGT
CGAAGATATCCGTTACACATCACGGAGCCC|CGAGAGAGTAGGGCCCTAAAAATCACTCCC
CCGAAGATATCCGTTCCAATAAGCGGAGCC|GAAGCCTCCTTCGTTAAATCTAATACTTTC
GTTACACAGAAATAGTCATGGCACTTTGCA|TACAAGACACATCTGCATTTACCAATAAGC
AGATATCCGTTACCCCAGTCCAGAAGCCTC|CGGAGCCGAAGATATCCGTTACACTTCCAA
GCCAATAAGCGGAGCCGAAGATATCCGTTA|GAGCCGAAGATATCCGTTACAACCACTGGG
GATGCACCCCCAATAAGCGGAGCCGAAGAT|CCCTCAATGGAGAACTTCGCCCGGTAGTAT
ACGTTTAATAACGGATTTATCGAAAGAACG|GTTATCCACTGCCGCCAATAAGCGGAGCCG
GATATCCGTTACACATCACGGAGCCCACGC|AGAGTAGGGCCCTAAAAATCACTCCCCCTA
TAGGTGAGTCTAATAACACAAGATGCACCC|CCGGCGGCAGATAAAACCTACCCCTCAATG
GTAAACGTCGTCTTTTCGCCAGATTCTTGT|TTAGCAAGTCTGCATCTCCAATGCAGAGCC
TTCGCCCGGTAGTATGACCGCGCAAGGTTT|GCCGAAGATATCCGTTACTGGGCTGACGAG
CCATTGTGTACGTCGCGTTAAACATATCCC|CCGTTACACAGATGGCCAATAAGCGGAGCC
GTGAGAGTTTAACTGGTGGCTATGGTGGAT|CCTGTATCCCAAGGGCCCAGGCGGCATGTG
GCCGAAGATATCCGTTACGTAAACGTCGTC|CGCGCCCGGCGAAGCGAATTAGCAAGTCTG
GGTCGTGCACGGGCCGTTGCCTACCATTGT|CCAATAAGCGGAGCCGAAGATATCCGTTAC
GTCCAGAAGCCTCCTTCGTTAAATCTAATA|GTTACACTTCCAATAAGCGGAGCCGAAGAT
ACTGAGTGAGAGTTTAACTGGTGGCTATGG|ACCCTCCTGTATCCCAAGGGCCCAGGCGGC
AATAAGCGGAGCCGAAGATATCCCAATAAG|TTTCTTTCTAAGCGGGAAGCCAATAAGCGG
GTAGGCAGGCACCGACCGACGATCTGGTTT|ATCCGTTACCCTGGGGCCCTCAGTATTTTT
AGATATCCGTTACACAGATGGCCAATAAGC|CCTGACCGTGCATAATTAGGTGAGTATGAT
CTAAACCCTCCTGTATCCCAAGGGCCCAGG|AGCGGAGCCGAAGATATCCGTTACGTAAAC
GTTACCCCAGTCCAGAAGCCTCCTTCGTTA|AAGATATCCGTTACACTTCCAATAAGCGGA
GTTTAACTGGTGGCTATGGTGGATCGACAA|TCCCAAGGGCCCAGGCGGCATGTGCAGTCC
GTGCATAATTAGGTGAGTATGATGGCGATG|TAAGCGGAGCCGAAGATATCCGTTACTCGG
CCGTTACACTTCCAATAAGCGGAGCCGAAG|CCGCGCAAGGTTTTCCAATAAGCGGAGCCG
GGGCTGACGAGTTTTTTCTTTCTAAGCGGG|CGCTGTAAGTGGACTCGTAACGACTGAGTG
TACGTCGCGTTAAACATATCCCTATAGACA|CAGATGGCCAATAAGCGGAGCCGAAGATAT
CGAGTTTTTTCTTTCTAAGCGGGAAGCCAA|AGTGGACTCGTAACGACTGAGTGAGAGTTT
AGATATCCCAATAAGCGGAGCCGAAGATAT|GAAGCCAATAAGCGGAGCCGAAGATATCCG
AAGAACCTGCGGGAACAAACACGATAAAAT|TACACATCACGGAGCCCACGCTACATCCAA
ACACAAGATGCACCCCCAATAAGCGGAGCC|ACCTACCCCTCAATGGAGAACTTCGCCCGG
AGGCGGCATGTGCAGTCCAATAAGCGGAGC|AACGTCGTCTTTTCGCCAGATTCTTGTGCC
CTGAGTGAGAGTTTAACTGGTGGCTATGGT|CCCTCCTGTATCCCAAGGGCCCAGGCGGCA
ATTTACCAATAAGCGGAGCCGAAGATATCC|TAGGCAGGCACCGACCGACGATCTGGTTTA
GAAGATATCCGTTACACATCACGGAGCCCA|GAGAGAGTAGGGCCCTAAAAATCACTCCCC
AATAACACAAGATGCACCCCCAATAAGCGG|TAAAACCTACCCCTCAATGGAGAACTTCGC
GATATCCGTTACTCGGACCGGCGGCAGATA|TCCGTTACCGTTACACAGAAATAGTCATGG
GACTATTCTAAACCCTCCTGTATCCCAAGG|CCCAATAAGCGGAGCCGAAGATATCCGTTA
ACTTTGCACGCCAATAAGCGGAGCCGAAGA|CAATAAGCGGAGCCGAAGATATCCGTTACA
GATATCCGTTACAACCACTGGGTACGCTGT|TGGTTTATCGGCCATACAGGAATCCAGATC
TCGCTAGCGGACCCAATAAGCGGAGCCGAA|TGCGGGAACAAACACGATAAAATACGCGCC
TAAGCGGAGCCGAAGATATCCGTTACTCGG|CGGAGCCGAAGATATCCGTTACCGTTACAC
TACACTTCCAATAAGCGGAGCCGAAGATAT|GCAAGGTTTTCCAATAAGCGGAGCCGAAGA
GACGAGTTTTTTCTTTCTAAGCGGGAAGCC|TAAGTGGACTCGTAACGACTGAGTGAGAGT
CAGATCTTCATGACTATTCTAAACCCTCCT|TCGCTAGCGGACCCAATAAGCGGAGCCGAA
TGCGGGAACAAACACGATAAAATACGCGCC|CACGGAGCCCACGCTACATCCAACGCCCGA
TAAACATATCCCTATAGACAATAGTCTGGT|ATAAGCGGAGCCGAAGATATCCGTTACCTT
CAGATAAAACCTACCCCTCAATGGAGAACT|TCATGGCACTTTGCACGCCAATAAGCGGAG
TTACCCCAATAAGCGGAGCCGAAGATATCC|CCCAATAAGCGGAGCCGAAGATATCCGTTA
CAAGGGCCCAGGCGGCATGTGCAGTCCAAT|CGTTACGTAAACGTCGTCTTTTCGCCAGAT
CTTATCAACCAATAAGCGGAGCCGAAGATA|TAACACAAGATGCACCCCCAATAAGCGGAG
TATCCGTTACCCCAGTCCAGAAGCCTCCTT|AGCCGAAGATATCCGTTACACTTCCAATAA
TCCGTTACGTAAACGTCGTCTTTTCGCCAG|GAAGCGAATTAGCAAGTCTGCATCTCCAAT
CCCCAATAAGCGGAGCCGAAGATATCCGTT|AATAAGCGGAGCCGAAGATATCCGTTACCG
TTACACAGAAATAGTCATGGCACTTTGCAC|ACAAGACACATCTGCATTTACCAATAAGCG
GAGCCGAAGATATCCGTTACTGGGCTGACG|ATCCGTTACAACCACTGGGTACGCTGTAAG
GTTAAACATATCCCTATAGACAATAGTCTG|CAATAAGCGGAGCCGAAGATATCCGTTACC
GTGCACGGGCCGTTGCCTACCATTGTGTAC|TAAGCGGAGCCGAAGATATCCGTTACACAG
AAGCGGAGCCGAAGATATCCGTTACCCCAA|AATAAGCGGAGCCGAAGATATCCCAATAAG
CGCCAATAAGCGGAGCCGAAGATATCCGTT|GGAGCCGAAGATATCCGTTACAACCACTGG
AAACCTACCCCTCAATGGAGAACTTCGCCC|CACTTTGCACGCCAATAAGCGGAGCCGAAG
AGGGGGTCGTGCACGGGCCGTTGCCTACCA|CGTTCCAATAAGCGGAGCCGAAGATATCCG
TTACAGCATACAAGACACATCTGCATTTAC|ACAACTGAGTTGGAACGTTCTTTGTAGGCA
CGGAGCCGAAGATATCCCAATAAGCGGAGC|TCTAAGCGGGAAGCCAATAAGCGGAGCCGA
CGCTGTAAGTGGACTCGTAACGACTGAGTG|CAGATCTTCATGACTATTCTAAACCCTCCT
GCAGGCACCGACCGACGATCTGGTTTATCG|GTTACCCTGGGGCCCTCAGTATTTTTTTAA
ACTGGGCTGACGAGTTTTTTCTTTCTAAGC|GTACGCTGTAAGTGGACTCGTAACGACTGA
TAAGCGGAGCCGAAGATATCCGTTACCGTT|GCGGAGCCGAAGATATCCGTTACAGCATAC
GATATCCCAATAAGCGGAGCCGAAGATATC|AAGCCAATAAGCGGAGCCGAAGATATCCGT
GCGGAGCCGAAGATATCCGTTACAACCACT|GACCGACGATCTGGTTTATCGGCCATACAG
CTTTGTAGGCAGGCACCGACCGACGATCTG|AGATATCCGTTACCCTGGGGCCCTCAGTAT
GCATGTGCAGTCCAATAAGCGGAGCCGAAG|CGTCTTTTCGCCAGATTCTTGTGCCTGTTG
TCCGTTACCCCAATAAGCGGAGCCGAAGAT|ATATCCCAATAAGCGGAGCCGAAGATATCC
AGCCTTGAGCAAAGGTTATCCACTGCCGCC|ACGGGGTATCTTCCGGTGGGCCACCCTCCA
AAGCGGGAAGCCAATAAGCGGAGCCGAAGA|CTGAGTGAGAGTTTAACTGGTGGCTATGGT
GCGGAGCCGAAGATATCCGTTACACAGATG|ATACTTTCGTCCTGACCGTGCATAATTAGG
CGACCGACGATCTGGTTTATCGGCCATACA|GGGGCCCTCAGTATTTTTTTAATGTGGACA
GACCCAATAAGCGGAGCCGAAGATATCCGT|AAACACGATAAAATACGCGCCCGGCGAAGC
AATAAGCGGAGCCGAAGATATCCGTTACAC|ATCTAATACTTTCGTCCTGACCGTGCATAA
CCCTCAATGGAGAACTTCGCCCGGTAGTAT|ACGCCAATAAGCGGAGCCGAAGATATCCGT
GCGGGAAGCCAATAAGCGGAGCCGAAGATA|GAGTGAGAGTTTAACTGGTGGCTATGGTGG
GACCGTGCATAATTAGGTGAGTATGATGGC|CCAATAAGCGGAGCCGAAGATATCCGTTAC
CACTTTGCACGCCAATAAGCGGAGCCGAAG|CCAATAAGCGGAGCCGAAGATATCCGTTAC
TTAAATCTAATACTTTCGTCCTGACCGTGC|GGAGCCGAAGATATCCGTTACCCCAATAAG
GCGGAGCCGAAGATATCCGTTACGTAAACG|AAATACGCGCCCGGCGAAGCGAATTAGCAA
CGTCCTGACCGTGCATAATTAGGTGAGTAT|GTTACCCCAATAAGCGGAGCCGAAGATATC
CTGCCGCCAATAAGCGGAGCCGAAGATATC|ACCCTCCAAAAATACGGCTACGAGAGAGTA
CAGAAGCCTCCTTCGTTAAATCTAATACTT|ACACTTCCAATAAGCGGAGCCGAAGATATC
ACATCTGGATCGCTAGCGGACCCAATAAGC|TCAAGAACCTGCGGGAACAAACACGATAAA
GCCCTCAGTATTTTTTTAATGTGGACATCT|TTTATCGAAAGAACGCAGGAAGTGTCAAGA
AGTTGGAACGTTCTTTGTAGGCAGGCACCG|AAGCGGAGCCGAAGATATCCGTTACCCTGG
GTCAAGAACCTGCGGGAACAAACACGATAA|CGTTACACATCACGGAGCCCACGCTACATC
TACCCCAGTCCAGAAGCCTCCTTCGTTAAA|GATATCCGTTACACTTCCAATAAGCGGAGC
TCCGTTACCCCAGTCCAGAAGCCTCCTTCG|CCGAAGATATCCGTTACACTTCCAATAAGC
GGCAGGCACCGACCGACGATCTGGTTTATC|CGTTACCCTGGGGCCCTCAGTATTTTTTTA
AAGGTTATCCACTGCCGCCAATAAGCGGAG|TCCGGTGGGCCACCCTCCAAAAATACGGCT
AAAACCTACCCCTCAATGGAGAACTTCGCC|GCACTTTGCACGCCAATAAGCGGAGCCGAA
GAGCCGAAGATATCCGTTACACTTCCAATA|CCCGGTAGTATGACCGCGCAAGGTTTTCCA
CAAGATGCACCCCCAATAAGCGGAGCCGAA|TACCCCTCAATGGAGAACTTCGCCCGGTAG
CAGTATTTTTTTAATGTGGACATCTGGATC|CGAAAGAACGCAGGAAGTGTCAAGAACCTG
TGCCTGTTGTAACGTTTAATAACGGATTTA|CTTGAGCAAAGGTTATCCACTGCCGCCAAT
TCCGTTACCGTTACACAGAAATAGTCATGG|GTTACAGCATACAAGACACATCTGCATTTA
ATCCACTGCCGCCAATAAGCGGAGCCGAAG|GGGCCACCCTCCAAAAATACGGCTACGAGA
TTAATGTGGACATCTGGATCGCTAGCGGAC|CAGGAAGTGTCAAGAACCTGCGGGAACAAA
ATAGACAATAGTCTGGTATCGAAGGGTAGT|AAGATATCCGTTACCTTATCAACCAATAAG
ATGACTATTCTAAACCCTCCTGTATCCCAA|GACCCAATAAGCGGAGCCGAAGATATCCGT
TAACTGGTGGCTATGGTGGATCGACAACTG|CAAGGGCCCAGGCGGCATGTGCAGTCCAAT
GCTGTAAGTGGACTCGTAACGACTGAGTGA|AGATCTTCATGACTATTCTAAACCCTCCTG
ATCCGTTCCAATAAGCGGAGCCGAAGATAT|CTTCGTTAAATCTAATACTTTCGTCCTGAC
ACCGCGCAAGGTTTTCCAATAAGCGGAGCC|ACTGGGCTGACGAGTTTTTTCTTTCTAAGC
AGGTGAGTCTAATAACACAAGATGCACCCC|CGGCGGCAGATAAAACCTACCCCTCAATGG
TATGACCGCGCAAGGTTTTCCAATAAGCGG|CGTTACTGGGCTGACGAGTTTTTTCTTTCT
CCATACAGGAATCCAGATCTTCATGACTAT|GTGGACATCTGGATCGCTAGCGGACCCAAT
CGTCGTCTTTTCGCCAGATTCTTGTGCCTG|AAGTCTGCATCTCCAATGCAGAGCCTTGAG
ATGGCACTTTGCACGCCAATAAGCGGAGCC|TTTACCAATAAGCGGAGCCGAAGATATCCG
GAGCCGAAGATATCCGTTACTCGGACCGGC|CGAAGATATCCGTTACCGTTACACAGAAAT
ATCCGTTACAGCATACAAGACACATCTGCA|GATCGACAACTGAGTTGGAACGTTCTTTGT
AAGCGGAGCCGAAGATATCCGTTACCCTGG|TCTTGTGCCTGTTGTAACGTTTAATAACGG
GTTACAACCACTGGGTACGCTGTAAGTGGA|TCGGCCATACAGGAATCCAGATCTTCATGA
TTCCAATAAGCGGAGCCGAAGATATCCCAA|GTTTTTTCTTTCTAAGCGGGAAGCCAATAA
CGTTAAATCTAATACTTTCGTCCTGACCGT|GCGGAGCCGAAGATATCCGTTACCCCAATA
AAGCGGAGCCGAAGATATCCGTTACAGCAT|ACTGGTGGCTATGGTGGATCGACAACTGAG
AATAAGCGGAGCCGAAGATATCCGTTACCC|TCCAATAAGCGGAGCCGAAGATATCCCAAT
GGAAGCCAATAAGCGGAGCCGAAGATATCC|TGAGAGTTTAACTGGTGGCTATGGTGGATC
ATACGCGCCCGGCGAAGCGAATTAGCAAGT|AACGCCCGACAAGGGATAATGCAAGGTTCG
CAATAAGCGGAGCCGAAGATATCCCAATAA|TTTTCTTTCTAAGCGGGAAGCCAATAAGCG
GTTACCTTATCAACCAATAAGCGGAGCCGA|TCTAATAACACAAGATGCACCCCCAATAAG
GTGGACATCTGGATCGCTAGCGGACCCAAT|AGTGTCAAGAACCTGCGGGAACAAACACGA
TGCAGTCCAATAAGCGGAGCCGAAGATATC|TTTCGCCAGATTCTTGTGCCTGTTGTAACG
GACATCTGGATCGCTAGCGGACCCAATAAG|GTCAAGAACCTGCGGGAACAAACACGATAA
TCCCTATAGACAATAGTCTGGTATCGAAGG|AGCCGAAGATATCCGTTACCTTATCAACCA
ATAAGCGGAGCCGAAGATATCCGTTCCAAT|CCCCAGTCCAGAAGCCTCCTTCGTTAAATC
ACAGCATACAAGACACATCTGCATTTACCA|AACTGAGTTGGAACGTTCTTTGTAGGCAGG
GCGAAGCGAATTAGCAAGTCTGCATCTCCA|AGGGATAATGCAAGGTTCGAGTTACGACAA
CATCTCCAATGCAGAGCCTTGAGCAAAGGT|TACGACAAATCGCAACGGGGTATCTTCCGG
CCTCCTGTATCCCAAGGGCCCAGGCGGCAT|GCCGAAGATATCCGTTACGTAAACGTCGTC
ATGGCCAATAAGCGGAGCCGAAGATATCCG|AGGTGAGTATGATGGCGATGGTAGGTGAGT
ACTTCGCCCGGTAGTATGACCGCGCAAGGT|GAGCCGAAGATATCCGTTACTGGGCTGACG
ATCCCAATAAGCGGAGCCGAAGATATCCGT|CCAATAAGCGGAGCCGAAGATATCCGTTAC
AATAAGCGGAGCCGAAGATATCCGTTACCC|TGCACCCCCAATAAGCGGAGCCGAAGATAT
GCCCCAATAAGCGGAGCCGAAGATATCCGT|CCGTTACCCCAGTCCAGAAGCCTCCTTCGT
CGCAAGGTTTTCCAATAAGCGGAGCCGAAG|GGCTGACGAGTTTTTTCTTTCTAAGCGGGA
